"seqname","id","strand","pos","p1.pos","m1.pos","dist","descr","start","end","chrom"
"chrI","YAL001C (TFC3 FUN24 TSV115)","-",147536,147461,147676,215,"F-close-F",147461,147676,"chrI"
"chrI","YAL002W (VPS8 FUN15 VPL8 VPT8)","+",147589,147676,147461,215,"F-close-F",147461,147676,"chrI"
"chrI","YAL003W (EFB1 TEF5)","+",143381,143626,143311,315,"W-open-W",143311,143626,"chrI"
"chrI","YAL004W","+",141543,141572,141468,104,"F-overlap-F",141468,141572,"chrI"
"chrI","YAL005C (SSA1 YG100)","-",139357,139271,139391,120,"F-close-F",139271,139391,"chrI"
"chrI","YAL007C (ERP2)","-",137552,137410,137582,172,"F-close-W",137410,137582,"chrI"
"chrI","YAL008W (FUN14)","+",137642,137760,137582,178,"F-close-W",137582,137760,"chrI"
"chrI","YAL009W (SPO7)","+",136756,136921,136708,213,"W-close-W",136708,136921,"chrI"
"chrI","YAL010C (MDM10 FUN37)","-",134079,134041,134257,216,"F-open-W",134041,134257,"chrI"
"chrI","YAL011W (SWC3 SWC1)","+",134173,134257,134041,216,"W-open-F",134041,134257,"chrI"
"chrI","YAL012W (CYS3 CYI1 FUN35 STR1)","+",132082,132231,131975,256,"W-open-W",131975,132231,"chrI"
"chrI","YAL013W (DEP1 FUN54)","+",130588,130758,130454,304,"W-open-W",130454,130758,"chrI"
"chrI","YAL014C (SYN8 SLT2 UIP2)","-",128118,128046,128261,215,"F-close-W",128046,128261,"chrI"
"chrI","YAL015C (NTG1 FUN33 SCR1 ogg2)","-",126896,126808,127036,228,"W-open-F",126808,127036,"chrI"
"chrI","YAL016C-B","-",124034,124033,124224,191,"W-close-W",124033,124224,"chrI"
"chrI","YAL016W (TPD3 FUN32)","+",126870,127036,126808,228,"F-open-W",126808,127036,"chrI"
"chrI","YAL017W (PSK1 FUN31)","+",124494,124578,124368,210,"F-close-W",124368,124578,"chrI"
"chrI","YAL018C","-",118426,118404,118501,97,"F-overlap-F",118404,118501,"chrI"
"chrI","YAL019W (FUN30)","+",118386,118404,118235,169,"F-close-F",118235,118404,"chrI"
"chrI","YAL020C (ATS1 FUN28 KTI13)","-",113537,113424,113630,206,"W-close-F",113424,113630,"chrI"
"chrI","YAL021C (CCR4 FUN27 NUT21)","-",110616,110408,110671,263,"W-open-W",110408,110671,"chrI"
"chrI","YAL022C (FUN26)","-",108820,108603,108933,330,"W-open-W",108603,108933,"chrI"
"chrI","YAL023C (PMT2 FUN25)","-",106157,106166,106355,189,"W-close-W",106166,106355,"chrI"
"chrI","YAL024C (LTE1 MSI2)","-",101384,101146,101411,265,"W-open-W",101146,101411,"chrI"
"chrI","YAL025C (MAK16)","-",100038,99991,100195,204,"W-close-F",99991,100195,"chrI"
"chrI","YAL026C (DRS2 FUN38 SWA3)","-",95563,95503,95729,226,"F-open-W",95503,95729,"chrI"
"chrI","YAL027W (SAW1)","+",95578,95729,95503,226,"W-open-F",95503,95729,"chrI"
"chrI","YAL028W (FRT2 HPH2)","+",94529,94673,94432,241,"W-open-W",94432,94673,"chrI"
"chrI","YAL029C (MYO4 FUN22 SHE1)","-",87768,87647,87791,144,"F-close-W",87647,87791,"chrI"
"chrI","YAL030W (SNC1)","+",87879,88002,87791,211,"F-close-W",87791,88002,"chrI"
"chrI","YAL031C (GIP4 FUN21)","-",84584,84453,84706,253,"W-open-W",84453,84706,"chrI"
"chrI","YAL032C (PRP45 FUN20)","-",83204,83075,83255,180,"W-close-W",83075,83255,"chrI"
"chrI","YAL033W (POP5 FUN53)","+",83306,83397,83255,142,"W-close-W",83255,83397,"chrI"
"chrI","YAL034C (FUN19)","-",80596,80608,80750,142,"F-close-F",80608,80750,"chrI"
"chrI","YAL034C-B (YAL035C-A)","-",79445,79386,79495,109,"W-overlap-F",79386,79495,"chrI"
"chrI","YAL034W-A (MTW1 DSN3 NSL2)","+",80675,80750,80608,142,"F-close-F",80608,80750,"chrI"
"chrI","YAL035W (FUN12 yIF2)","+",79561,79732,79495,237,"W-open-W",79495,79732,"chrI"
"chrI","YAL036C (RBG1 FUN11)","-",74850,74739,74909,170,"F-close-F",74739,74909,"chrI"
"chrI","YAL037C-A","-",73385,73231,73513,282,"W-open-F",73231,73513,"chrI"
"chrI","YAL037C-B","-",71754,71601,71863,262,"F-open-F",71601,71863,"chrI"
"chrI","YAL037W","+",74966,75185,74909,276,"F-open-F",74909,75185,"chrI"
"chrI","YAL038W (CDC19 PYK1)","+",73446,73513,73231,282,"F-open-W",73231,73513,"chrI"
"chrI","YAL039C (CYC3)","-",68647,NA,NA,NA,"+1_missing",68258,68752,"chrI"
"chrI","YAL040C (CLN3 DAF1 FUN10 WHI1)","-",65601,65507,65738,231,"F-open-W",65507,65738,"chrI"
"chrI","YAL041W (CDC24 CLS4)","+",65463,65507,65409,98,"F-overlap-W",65409,65507,"chrI"
"chrI","YAL042W (ERV46 FUN9)","+",62654,62823,62534,289,"W-open-W",62534,62823,"chrI"
"chrI","YAL043C (PTA1 FUN39)","-",58619,58433,58678,245,"W-open-W",58433,58678,"chrI"
"chrI","YAL044C (GCV3)","-",57868,57728,57905,177,"W-close-W",57728,57905,"chrI"
"chrI","YAL044W-A","+",57974,58080,57905,175,"W-close-W",57905,58080,"chrI"
"chrI","YAL045C","-",57373,57348,57547,199,"W-close-W",57348,57547,"chrI"
"chrI","YAL046C (AIM1)","-",56907,56818,57036,218,"W-open-W",56818,57036,"chrI"
"chrI","YAL047C (SPC72 LDB4)","-",54934,54735,54977,242,"W-open-W",54735,54977,"chrI"
"chrI","YAL047W-A","+",55113,55133,54977,156,"W-close-W",54977,55133,"chrI"
"chrI","YAL048C (GEM1 GON1)","-",52697,52597,52872,275,"W-open-W",52597,52872,"chrI"
"chrI","YAL049C (AIM2)","-",51736,51728,51815,87,"F-overlap-F",51728,51815,"chrI"
"chrI","YAL051W (OAF1 YAF1)","+",51847,51947,51815,132,"F-close-W",51815,51947,"chrI"
"chrI","YAL053W (FLC2 HUF2)","+",48322,48559,48250,309,"W-open-W",48250,48559,"chrI"
"chrI","YAL054C (ACS1 FUN44)","-",42718,42713,42920,207,"W-close-W",42713,42920,"chrI"
"chrI","YAL055W (PEX22 YAF5)","+",42804,42920,42713,207,"W-close-W",42713,42920,"chrI"
"chrI","YAL056W (GPB2 KRH1)","+",41999,42227,41957,270,"F-open-W",41957,42227,"chrI"
"chrI","YAL058W (CNE1 FUN48)","+",39104,39266,38969,297,"W-open-W",38969,39266,"chrI"
"chrI","YAL059W (ECM1)","+",37338,37439,37228,211,"W-close-W",37228,37439,"chrI"
"chrI","YAL060W (BDH1 BDH)","+",36415,36585,36327,258,"W-open-W",36327,36585,"chrI"
"chrI","YAL061W (BDH2)","+",34874,34863,34753,110,"F-overlap-W",34753,34863,"chrI"
"chrI","YAL062W (GDH3 FUN51)","+",33026,33220,32898,322,"W-open-W",32898,33220,"chrI"
"chrI","YAL064W-B","+",12980,13226,12907,319,"F-open-F",12907,13226,"chrI"
"chrI","YAL067C (SEO1)","-",7016,6954,7150,196,"W-close-W",6954,7150,"chrI"
"chrI","YAR002C-A (ERP1)","-",153957,153894,154045,151,"F-close-F",153894,154045,"chrI"
"chrI","YAR002W (NUP60)","+",153970,154045,153894,151,"F-close-F",153894,154045,"chrI"
"chrI","YAR003W (SWD1 CPS50 FUN16 SAF49)","+",156780,156827,156599,228,"F-open-W",156599,156827,"chrI"
"chrI","YAR007C (RFA1 BUF2 FUN3 RPA1)","-",156681,156599,156827,228,"W-open-F",156599,156827,"chrI"
"chrI","YAR008W (SEN34 FUN4)","+",159890,159965,159852,113,"W-overlap-F",159852,159965,"chrI"
"chrI","YAR014C (BUD14)","-",166564,166449,166654,205,"W-close-W",166449,166654,"chrI"
"chrI","YAR015W (ADE1)","+",170409,170465,170388,77,"F-overlap-F",170388,170465,"chrI"
"chrI","YAR018C (KIN3 FUN52 NPK1)","-",170313,170209,170388,179,"F-close-F",170209,170388,"chrI"
"chrI","YAR019C (CDC15 LYT1)","-",172126,172116,172294,178,"W-close-W",172116,172294,"chrI"
"chrI","YAR023C","-",179251,179247,179379,132,"W-close-F",179247,179379,"chrI"
"chrI","YAR027W (UIP3)","+",184605,184623,184510,113,"F-overlap-W",184510,184623,"chrI"
"chrI","YAR028W","+",185794,185944,185688,256,"W-open-F",185688,185944,"chrI"
"chrI","YAR029W","+",186766,186794,186626,168,"W-close-W",186626,186794,"chrI"
"chrI","YAR033W (MST28)","+",188904,188957,188868,89,"W-overlap-F",188868,188957,"chrI"
"chrI","YAR035W (YAT1)","+",192365,192456,192315,141,"W-close-F",192315,192456,"chrI"
"chrI","YAR042W (SWH1 OSH1 YAR044W)","+",196349,196364,196277,87,"F-overlap-F",196277,196364,"chrI"
"chrI","YAR066W","+",221759,NA,NA,NA,"+1_missing",210806,223028,"chrI"
"chrII","YBL001C (ECM15)","-",237064,236889,237126,237,"W-open-F",236889,237126,"chrII"
"chrII","YBL002W (HTB2)","+",237087,237126,236889,237,"F-open-W",236889,237126,"chrII"
"chrII","YBL003C (HTA2 H2A2)","-",235199,235155,235235,80,"F-overlap-F",235155,235235,"chrII"
"chrII","YBL004W (UTP20)","+",235175,235235,235155,80,"F-overlap-F",235155,235235,"chrII"
"chrII","YBL005W (PDR3 AMY2 TPE2)","+",220685,220739,220640,99,"F-overlap-F",220640,220739,"chrII"
"chrII","YBL006C (LDB7 RSC14)","-",216405,216367,216651,284,"W-open-W",216367,216651,"chrII"
"chrII","YBL007C (SLA1)","-",212548,212298,212654,356,"F-open-F",212298,212654,"chrII"
"chrII","YBL008W (HIR1)","+",212256,212298,212158,140,"F-close-F",212158,212298,"chrII"
"chrII","YBL009W (ALK2)","+",209350,209413,209215,198,"F-close-W",209215,209413,"chrII"
"chrII","YBL010C","-",205899,205846,206077,231,"W-open-F",205846,206077,"chrII"
"chrII","YBL011W (SCT1 GAT2)","+",206022,206077,205846,231,"F-open-W",205846,206077,"chrII"
"chrII","YBL014C (RRN6)","-",198947,198886,199097,211,"W-close-W",198886,199097,"chrII"
"chrII","YBL015W (ACH1)","+",195953,196075,195902,173,"W-close-W",195902,196075,"chrII"
"chrII","YBL016W (FUS3 DAC2)","+",193647,193920,193476,444,"F-open-F",193476,193920,"chrII"
"chrII","YBL017C (PEP1 VPS10 VPT1)","-",186771,NA,NA,NA,"+1_missing",186470,186923,"chrII"
"chrII","YBL018C (POP8)","-",185933,185808,186114,306,"W-open-F",185808,186114,"chrII"
"chrII","YBL019W (APN2 ETH1)","+",186027,186114,185808,306,"F-open-W",185808,186114,"chrII"
"chrII","YBL020W (RFT1)","+",184205,184363,184167,196,"F-close-W",184167,184363,"chrII"
"chrII","YBL021C (HAP3)","-",181490,181365,181623,258,"W-open-W",181365,181623,"chrII"
"chrII","YBL022C (PIM1 LON1)","-",177798,177550,177843,293,"W-open-F",177550,177843,"chrII"
"chrII","YBL023C (MCM2)","-",174739,174625,174809,184,"F-close-F",174625,174809,"chrII"
"chrII","YBL024W (NCL1 TRM4)","+",174713,174809,174625,184,"F-close-F",174625,174809,"chrII"
"chrII","YBL025W (RRN10)","+",172384,172550,172086,464,"W-open-W",172086,172550,"chrII"
"chrII","YBL026W (LSM2 SMX5 SNP3)","+",171172,171210,171042,168,"F-close-W",171042,171210,"chrII"
"chrII","YBL027W (RPL19B)","+",169466,NA,NA,NA,"+1_missing",169374,169770,"chrII"
"chrII","YBL028C","-",167301,167188,167508,320,"F-open-W",167188,167508,"chrII"
"chrII","YBL029C-A","-",164360,164110,164529,419,"W-open-F",164110,164529,"chrII"
"chrII","YBL029W","+",167371,167508,167188,320,"W-open-F",167188,167508,"chrII"
"chrII","YBL030C (PET9 AAC2 ANC2 OP1)","-",162774,162719,NA,NA,"-1_missing",162719,163107,"chrII"
"chrII","YBL031W (SHE1)","+",162865,163107,162719,388,"F-open-F",162719,163107,"chrII"
"chrII","YBL032W (HEK2 KHD1)","+",161509,161719,161442,277,"F-open-W",161442,161719,"chrII"
"chrII","YBL033C (RIB1)","-",158587,158425,158709,284,"W-open-W",158425,158709,"chrII"
"chrII","YBL034C (STU1)","-",153664,153666,153954,288,"W-open-W",153666,153954,"chrII"
"chrII","YBL035C (POL12)","-",151447,151199,151478,279,"W-open-W",151199,151478,"chrII"
"chrII","YBL036C","-",150301,150196,150357,161,"F-close-W",150196,150357,"chrII"
"chrII","YBL037W (APL3)","+",150403,150524,150357,167,"F-close-W",150357,150524,"chrII"
"chrII","YBL038W (MRPL16)","+",146965,147170,146907,263,"W-open-W",146907,147170,"chrII"
"chrII","YBL039C (URA7)","-",143805,NA,NA,NA,"+1_missing",143491,143831,"chrII"
"chrII","YBL039W-B (YBL039W-A)","+",143707,143831,143491,340,"F-open-F",143491,143831,"chrII"
"chrII","YBL040C (ERD2)","-",142025,141965,142169,204,"W-close-F",141965,142169,"chrII"
"chrII","YBL041W (PRE7 PRS3)","+",142040,142169,141965,204,"F-close-W",141965,142169,"chrII"
"chrII","YBL042C (FUI1)","-",138290,138112,138418,306,"F-open-F",138112,138418,"chrII"
"chrII","YBL043W (ECM13)","+",137644,137761,137545,216,"F-open-F",137545,137761,"chrII"
"chrII","YBL045C (COR1 QCR1)","-",133961,133876,134037,161,"F-close-F",133876,134037,"chrII"
"chrII","YBL046W (PSY4)","+",133937,134037,133876,161,"F-close-F",133876,134037,"chrII"
"chrII","YBL047C (EDE1 BUD15)","-",127682,127569,127738,169,"F-close-F",127569,127738,"chrII"
"chrII","YBL049W (MOH1)","+",127301,127355,127273,82,"F-overlap-W",127273,127355,"chrII"
"chrII","YBL050W (SEC17 RNS3)","+",126186,126262,126071,191,"W-close-F",126071,126262,"chrII"
"chrII","YBL051C (PIN4 MDT1)","-",122306,122100,122368,268,"F-open-W",122100,122368,"chrII"
"chrII","YBL052C (SAS3)","-",119306,119248,119332,84,"F-overlap-F",119248,119332,"chrII"
"chrII","YBL054W (TOD6 PBF1)","+",119304,119332,119248,84,"F-overlap-F",119248,119332,"chrII"
"chrII","YBL055C (Tat-D)","-",115479,115298,115686,388,"W-open-F",115298,115686,"chrII"
"chrII","YBL056W (PTC3)","+",115437,115686,115298,388,"F-open-W",115298,115686,"chrII"
"chrII","YBL057C (PTH2)","-",112728,112716,112910,194,"W-close-F",112716,112910,"chrII"
"chrII","YBL058W (SHP1 UBX1)","+",112825,112910,112716,194,"F-close-W",112716,112910,"chrII"
"chrII","YBL059C-A (CMC2)","-",109941,109825,110005,180,"W-close-W",109825,110005,"chrII"
"chrII","YBL059W","+",111280,111457,111166,291,"W-open-W",111166,111457,"chrII"
"chrII","YBL060W (YEL1)","+",110033,110170,110005,165,"W-close-W",110005,110170,"chrII"
"chrII","YBL061C (SKT5 CAL2 CHS4 CSD4)","-",105248,105087,105339,252,"F-open-F",105087,105339,"chrII"
"chrII","YBL063W (KIP1 CIN9)","+",105299,105339,105087,252,"F-open-F",105087,105339,"chrII"
"chrII","YBL064C (PRX1)","-",100299,100115,100402,287,"F-open-W",100115,100402,"chrII"
"chrII","YBL066C (SEF1)","-",96342,96100,96362,262,"F-open-F",96100,96362,"chrII"
"chrII","YBL067C (UBP13)","-",93515,93374,93570,196,"F-close-W",93374,93570,"chrII"
"chrII","YBL068W (PRS4)","+",93488,93570,93374,196,"W-close-F",93374,93570,"chrII"
"chrII","YBL069W (AST1)","+",92162,92162,91979,183,"W-close-W",91979,92162,"chrII"
"chrII","YBL071C-B","-",88955,88965,89078,113,"F-overlap-W",88965,89078,"chrII"
"chrII","YBL071W-A (KTI11 DPH3)","+",90670,90717,90457,260,"F-open-W",90457,90717,"chrII"
"chrII","YBL072C (RPS8A)","-",88412,88381,NA,NA,"-1_missing",88381,88965,"chrII"
"chrII","YBL074C (AAR2)","-",86499,86434,86602,168,"W-close-W",86434,86602,"chrII"
"chrII","YBL075C (SSA3 YG106)","-",84418,84260,84573,313,"W-open-W",84260,84573,"chrII"
"chrII","YBL076C (ILS1)","-",80947,80715,81012,297,"W-open-W",80715,81012,"chrII"
"chrII","YBL078C (ATG8 APG8 AUT7 CVT5)","-",80214,80215,80391,176,"W-close-W",80215,80391,"chrII"
"chrII","YBL079W (NUP170 NLE3)","+",79854,79939,79826,113,"F-overlap-F",79826,79939,"chrII"
"chrII","YBL080C (PET112)","-",72965,72916,73001,85,"F-overlap-W",72916,73001,"chrII"
"chrII","YBL081W","+",73097,73096,73001,95,"F-overlap-W",73001,73096,"chrII"
"chrII","YBL082C (ALG3 RHK1)","-",69664,69510,69784,274,"W-open-W",69510,69784,"chrII"
"chrII","YBL084C (CDC27 APC3 SNB1)","-",67035,66965,67283,318,"F-open-F",66965,67283,"chrII"
"chrII","YBL085W (BOI1 BOB1 GIN7)","+",66934,66965,66747,218,"F-open-F",66747,66965,"chrII"
"chrII","YBL086C","-",61155,NA,NA,NA,"+1_missing",60776,61207,"chrII"
"chrII","YBL087C (RPL23A)","-",59719,59557,59778,221,"F-open-W",59557,59778,"chrII"
"chrII","YBL088C (TEL1)","-",50935,50952,51127,175,"F-close-F",50952,51127,"chrII"
"chrII","YBL089W (AVT5)","+",51025,51127,50952,175,"F-close-F",50952,51127,"chrII"
"chrII","YBL090W (MRP21 MRP50)","+",49481,49604,49372,232,"W-open-W",49372,49604,"chrII"
"chrII","YBL091C (MAP2)","-",47263,47144,47388,244,"W-open-W",47144,47388,"chrII"
"chrII","YBL091C-A (SCS22)","-",46433,46289,46482,193,"F-close-W",46289,46482,"chrII"
"chrII","YBL092W (RPL32)","+",46478,46482,46289,193,"W-close-F",46289,46482,"chrII"
"chrII","YBL093C (ROX3 MED19 NUT3 SSN7)","-",44116,43971,44147,176,"W-close-W",43971,44147,"chrII"
"chrII","YBL095W","+",44207,44317,44147,170,"W-close-W",44147,44317,"chrII"
"chrII","YBL097W (BRN1)","+",43265,43307,43030,277,"W-open-W",43030,43307,"chrII"
"chrII","YBL098W (BNA4)","+",40560,40807,40523,284,"W-open-W",40523,40807,"chrII"
"chrII","YBL099W (ATP1)","+",38922,38937,38727,210,"F-close-F",38727,38937,"chrII"
"chrII","YBL100W-C (YBL101W-C)","+",28686,28787,28597,190,"W-close-F",28597,28787,"chrII"
"chrII","YBL101C (ECM21 ART2)","-",24810,24694,24921,227,"F-open-F",24694,24921,"chrII"
"chrII","YBL102W (SFT2)","+",24920,24921,24694,227,"F-open-F",24694,24921,"chrII"
"chrII","YBL103C (RTG3)","-",21698,21694,21858,164,"W-close-W",21694,21858,"chrII"
"chrII","YBL104C (YBL103C-A)","-",18086,17904,18199,295,"W-open-W",17904,18199,"chrII"
"chrII","YBL105C (PKC1 CLY15 HPO2 STT1)","-",14104,14015,14166,151,"F-close-F",14015,14166,"chrII"
"chrII","YBL106C (SRO77 SNI2 SOP2)","-",10773,10768,10929,161,"W-close-F",10768,10929,"chrII"
"chrII","YBL107C","-",9835,9797,9980,183,"W-close-W",9797,9980,"chrII"
"chrII","YBR001C (NTH2)","-",238872,238838,239037,199,"W-close-F",238838,239037,"chrII"
"chrII","YBR002C (RER2)","-",241547,241387,241677,290,"W-open-W",241387,241677,"chrII"
"chrII","YBR003W (COQ1)","+",244357,244456,244318,138,"F-close-F",244318,244456,"chrII"
"chrII","YBR004C (GPI18 FMP44)","-",244273,244131,244318,187,"F-close-F",244131,244318,"chrII"
"chrII","YBR005W (RCR1 SSH6)","+",246703,246875,246641,234,"F-open-F",246641,246875,"chrII"
"chrII","YBR006W (UGA2 UGA5)","+",248649,248905,248508,397,"F-open-F",248508,248905,"chrII"
"chrII","YBR007C (DSF2)","-",248665,248508,248905,397,"F-open-F",248508,248905,"chrII"
"chrII","YBR008C (FLR1)","-",252433,252449,252700,251,"F-open-W",252449,252700,"chrII"
"chrII","YBR009C (HHF1)","-",255199,255165,255336,171,"W-close-W",255165,255336,"chrII"
"chrII","YBR010W (HHT1 BUR5 SIN2)","+",256898,256988,256629,359,"F-open-F",256629,256988,"chrII"
"chrII","YBR011C (IPP1 PPA1)","-",257000,256988,257074,86,"F-overlap-F",256988,257074,"chrII"
"chrII","YBR012C","-",258940,NA,NA,NA,"+1_missing",258608,266568,"chrII"
"chrII","YBR013C","-",265362,NA,NA,NA,"+1_missing",258608,266568,"chrII"
"chrII","YBR014C (GRX7)","-",266614,266568,266718,150,"W-close-W",266568,266718,"chrII"
"chrII","YBR015C (MNN2 CRV4 LDB8 TTP1)","-",267568,267541,267741,200,"F-close-F",267541,267741,"chrII"
"chrII","YBR016W","+",270840,270999,270571,428,"W-open-F",270571,270999,"chrII"
"chrII","YBR017C (KAP104)","-",270845,270571,270999,428,"F-open-W",270571,270999,"chrII"
"chrII","YBR018C (GAL7)","-",274266,274153,274491,338,"F-open-W",274153,274491,"chrII"
"chrII","YBR019C (GAL10)","-",276143,276064,276224,160,"W-close-W",276064,276224,"chrII"
"chrII","YBR020W (GAL1)","+",280728,280875,280529,346,"W-open-W",280529,280875,"chrII"
"chrII","YBR021W (FUR4)","+",283482,283486,283290,196,"W-close-W",283290,283486,"chrII"
"chrII","YBR022W (POA1)","+",284428,284438,284234,204,"W-close-F",284234,284438,"chrII"
"chrII","YBR023C (CHS3 CAL1 CSD2 DIT101 KTI2)","-",284274,284234,284438,204,"F-close-W",284234,284438,"chrII"
"chrII","YBR024W (SCO2)","+",290537,290568,290396,172,"F-close-F",290396,290568,"chrII"
"chrII","YBR025C (OLA1)","-",290470,290396,290568,172,"F-close-F",290396,290568,"chrII"
"chrII","YBR026C (ETR1 MRF1 MRF1')","-",292761,292698,292870,172,"W-close-W",292698,292870,"chrII"
"chrII","YBR028C","-",294382,294264,294440,176,"W-close-W",294264,294440,"chrII"
"chrII","YBR029C (CDS1 CDG1)","-",296238,296043,296275,232,"F-open-W",296043,296275,"chrII"
"chrII","YBR030W (RKM3)","+",300006,300162,299868,294,"W-open-W",299868,300162,"chrII"
"chrII","YBR031W (RPL4A)","+",301347,301367,301188,179,"F-close-F",301188,301367,"chrII"
"chrII","YBR033W (EDS1)","+",304864,304850,304672,178,"F-close-F",304672,304850,"chrII"
"chrII","YBR034C (HMT1 HCP1 ODP1 RMT1)","-",304740,304672,304850,178,"F-close-F",304672,304850,"chrII"
"chrII","YBR035C (PDX3)","-",306153,305976,306292,316,"W-open-W",305976,306292,"chrII"
"chrII","YBR036C (CSG2 CLS2)","-",308887,308672,308913,241,"F-open-F",308672,308913,"chrII"
"chrII","YBR037C (SCO1 PET161)","-",310495,310329,310626,297,"W-open-W",310329,310626,"chrII"
"chrII","YBR038W (CHS2)","+",314975,315095,314945,150,"W-close-F",314945,315095,"chrII"
"chrII","YBR039W (ATP3)","+",316688,316842,316647,195,"F-close-W",316647,316842,"chrII"
"chrII","YBR041W (FAT1)","+",320417,320580,320234,346,"F-open-F",320234,320580,"chrII"
"chrII","YBR042C (CST26 PSI1)","-",320343,320234,320580,346,"F-open-F",320234,320580,"chrII"
"chrII","YBR043C (QDR3 AQR2)","-",321737,321603,321859,256,"W-open-W",321603,321859,"chrII"
"chrII","YBR044C (TCM62)","-",324283,324054,324331,277,"W-open-W",324054,324331,"chrII"
"chrII","YBR045C (GIP1)","-",328022,327941,328121,180,"W-close-W",327941,328121,"chrII"
"chrII","YBR046C (ZTA1)","-",330246,330255,330356,101,"F-overlap-F",330255,330356,"chrII"
"chrII","YBR047W (FMP23)","+",332461,NA,NA,NA,"+1_missing",332366,332820,"chrII"
"chrII","YBR048W (RPS11B)","+",334027,334081,333976,105,"F-overlap-F",333976,334081,"chrII"
"chrII","YBR049C (REB1 GRF2)","-",334141,334081,334246,165,"W-close-F",334081,334246,"chrII"
"chrII","YBR050C (REG2)","-",337145,336872,337255,383,"W-open-F",336872,337255,"chrII"
"chrII","YBR052C (RFS1)","-",338663,338681,338854,173,"W-close-F",338681,338854,"chrII"
"chrII","YBR053C","-",339595,339373,339645,272,"W-open-W",339373,339645,"chrII"
"chrII","YBR054W (YRO2)","+",344518,344560,344453,107,"F-overlap-F",344453,344560,"chrII"
"chrII","YBR055C (PRP6 RNA6 TSM7269)","-",344509,344453,344560,107,"F-overlap-F",344453,344560,"chrII"
"chrII","YBR056C-B","-",351072,351076,351148,72,"F-overlap-W",351076,351148,"chrII"
"chrII","YBR056W","+",349433,349491,349311,180,"W-close-W",349311,349491,"chrII"
"chrII","YBR056W-A","+",351906,351985,351776,209,"F-close-F",351776,351985,"chrII"
"chrII","YBR057C (MUM2 SPOT8)","-",352074,351985,352122,137,"F-close-F",351985,352122,"chrII"
"chrII","YBR058C (UBP14 GID6)","-",353652,NA,NA,NA,"+1_missing",353343,353771,"chrII"
"chrII","YBR058C-A (TSC3)","-",356153,356015,356229,214,"W-close-W",356015,356229,"chrII"
"chrII","YBR059C (AKL1)","-",356775,356563,356848,285,"W-open-W",356563,356848,"chrII"
"chrII","YBR060C (ORC2 RRR1 SIR5)","-",360595,NA,NA,NA,"+1_missing",360274,360665,"chrII"
"chrII","YBR061C (TRM7)","-",364699,364526,364731,205,"F-close-W",364526,364731,"chrII"
"chrII","YBR062C","-",365872,365688,365909,221,"F-open-W",365688,365909,"chrII"
"chrII","YBR063C","-",366913,366764,366979,215,"W-close-F",366764,366979,"chrII"
"chrII","YBR065C (ECM2 SLT11)","-",368226,368195,368393,198,"F-close-W",368195,368393,"chrII"
"chrII","YBR066C (NRG2)","-",369938,369679,370004,325,"W-open-W",369679,370004,"chrII"
"chrII","YBR067C (TIP1)","-",371974,371889,372101,212,"W-close-W",371889,372101,"chrII"
"chrII","YBR068C (BAP2)","-",373642,373649,373833,184,"F-close-F",373649,373833,"chrII"
"chrII","YBR069C (TAT1 TAP1 VAP1)","-",376412,376413,376584,171,"W-close-W",376413,376584,"chrII"
"chrII","YBR070C (ALG14)","-",379178,379110,379266,156,"F-close-F",379110,379266,"chrII"
"chrII","YBR071W","+",381316,381423,381177,246,"F-open-F",381177,381423,"chrII"
"chrII","YBR072C-A","-",382732,382704,382900,196,"W-close-W",382704,382900,"chrII"
"chrII","YBR072W (HSP26)","+",382838,382900,382704,196,"W-close-W",382704,382900,"chrII"
"chrII","YBR074W (YBR075W)","+",389278,389571,389142,429,"F-open-W",389142,389571,"chrII"
"chrII","YBR076C-A","-",391174,391159,391334,175,"F-close-F",391159,391334,"chrII"
"chrII","YBR076W (ECM8)","+",391765,391895,391615,280,"W-open-W",391615,391895,"chrII"
"chrII","YBR077C (SLM4 EGO3 GSE1 NIR1)","-",391676,391615,391895,280,"W-open-W",391615,391895,"chrII"
"chrII","YBR078W (ECM33)","+",395042,395157,394960,197,"W-close-F",394960,395157,"chrII"
"chrII","YBR079C (RPG1 TIF32)","-",395294,395271,395481,210,"F-close-F",395271,395481,"chrII"
"chrII","YBR080C (SEC18 ANU4)","-",398481,398252,398534,282,"W-open-W",398252,398534,"chrII"
"chrII","YBR081C (SPT7 GIT2)","-",401139,400870,401177,307,"W-open-F",400870,401177,"chrII"
"chrII","YBR082C (UBC4)","-",406461,406314,406505,191,"F-close-W",406314,406505,"chrII"
"chrII","YBR083W (TEC1 ROC1)","+",410718,410725,410550,175,"W-close-W",410550,410725,"chrII"
"chrII","YBR084C-A (RPL19A)","-",414105,414124,414288,164,"W-close-F",414124,414288,"chrII"
"chrII","YBR084W (MIS1)","+",414116,414124,413926,198,"W-close-F",413926,414124,"chrII"
"chrII","YBR085C-A","-",418536,418503,418694,191,"F-close-F",418503,418694,"chrII"
"chrII","YBR085W (AAC3 ANC3)","+",417083,417075,416883,192,"F-close-F",416883,417075,"chrII"
"chrII","YBR086C (IST2)","-",420069,419976,420152,176,"F-close-W",419976,420152,"chrII"
"chrII","YBR087W (RFC5)","+",424889,424983,424821,162,"F-close-F",424821,424983,"chrII"
"chrII","YBR088C (POL30)","-",424913,424821,424983,162,"F-close-F",424821,424983,"chrII"
"chrII","YBR089C-A (NHP6B YBR090C-A)","-",426015,425818,426113,295,"F-open-W",425818,426113,"chrII"
"chrII","YBR091C (TIM12 MRS5)","-",427065,426829,427172,343,"W-open-W",426829,427172,"chrII"
"chrII","YBR092C (PHO3 phoC)","-",427647,427471,427764,293,"W-open-W",427471,427764,"chrII"
"chrII","YBR093C (PHO5 phoE)","-",429492,429444,429620,176,"W-close-W",429444,429620,"chrII"
"chrII","YBR094W (PBY1)","+",434300,434341,434264,77,"F-overlap-F",434264,434341,"chrII"
"chrII","YBR095C (RXT2 RAF60)","-",434314,434264,434341,77,"F-overlap-F",434264,434341,"chrII"
"chrII","YBR096W","+",436781,436959,436706,253,"W-open-W",436706,436959,"chrII"
"chrII","YBR097W (VPS15 GRD8 VAC4 VPL19 VPS40)","+",441430,441555,441290,265,"F-open-W",441290,441555,"chrII"
"chrII","YBR098W (MMS4 SLX2 YBR100W)","+",443757,443880,443701,179,"F-close-F",443701,443880,"chrII"
"chrII","YBR101C (FES1)","-",443780,443701,443880,179,"F-close-F",443701,443880,"chrII"
"chrII","YBR102C (EXO84 USA3)","-",444943,444701,445004,303,"W-open-W",444701,445004,"chrII"
"chrII","YBR103W (SIF2 EMB1)","+",449364,449576,449284,292,"W-open-W",449284,449576,"chrII"
"chrII","YBR104W (YMC2)","+",450744,450762,450600,162,"W-close-F",450600,450762,"chrII"
"chrII","YBR105C (VID24 GID4)","-",450741,450600,450762,162,"F-close-W",450600,450762,"chrII"
"chrII","YBR106W (PHO88)","+",453364,453365,453176,189,"W-close-F",453176,453365,"chrII"
"chrII","YBR107C (IML3 MCM19)","-",453442,453365,453625,260,"W-open-F",453365,453625,"chrII"
"chrII","YBR108W (AIM3)","+",457846,457887,457700,187,"W-close-W",457700,457887,"chrII"
"chrII","YBR109C (CMD1 CaM)","-",457721,457700,457887,187,"W-close-W",457700,457887,"chrII"
"chrII","YBR110W (ALG1)","+",460329,460326,460160,166,"W-close-W",460160,460326,"chrII"
"chrII","YBR111C (YSA1 RMA2)","-",461107,461045,461219,174,"W-close-W",461045,461219,"chrII"
"chrII","YBR111W-A (SUS1)","+",462746,462857,462587,270,"F-open-F",462587,462857,"chrII"
"chrII","YBR112C (CYC8 CRT8 SSN6)","-",462683,462587,462857,270,"F-open-F",462587,462857,"chrII"
"chrII","YBR114W (RAD16 PSO5)","+",469719,469727,469622,105,"W-overlap-F",469622,469727,"chrII"
"chrII","YBR115C (LYS2)","-",469611,469622,469727,105,"F-overlap-W",469622,469727,"chrII"
"chrII","YBR118W (TEF2 EF-1%20alpha)","+",479143,479192,479007,185,"F-close-F",479007,479192,"chrII"
"chrII","YBR119W (MUD1)","+",480443,480482,480312,170,"F-close-W",480312,480482,"chrII"
"chrII","YBR120C (CBP6)","-",480375,480312,480482,170,"W-close-F",480312,480482,"chrII"
"chrII","YBR121C (GRS1)","-",481250,481234,481422,188,"W-close-W",481234,481422,"chrII"
"chrII","YBR122C (MRPL36)","-",483774,483750,483923,173,"F-close-W",483750,483923,"chrII"
"chrII","YBR123C (TFC1)","-",484696,484500,484764,264,"W-open-W",484500,484764,"chrII"
"chrII","YBR125C (PTC4 GCT1)","-",486848,486676,486979,303,"W-open-W",486676,486979,"chrII"
"chrII","YBR126C (TPS1 BYP1 CIF1 FDP1 GGS1 GLC6 TSS1)","-",488774,488531,488805,274,"F-open-W",488531,488805,"chrII"
"chrII","YBR126W-A","+",491199,491246,491029,217,"W-open-F",491029,491246,"chrII"
"chrII","YBR126W-B","+",491199,491246,491029,217,"W-open-F",491029,491246,"chrII"
"chrII","YBR127C (VMA2 ATPSV VAT2)","-",491103,491029,491246,217,"F-open-W",491029,491246,"chrII"
"chrII","YBR128C (ATG14 APG14 CVT12)","-",492999,492817,493106,289,"W-open-W",492817,493106,"chrII"
"chrII","YBR129C (OPY1)","-",494246,494099,494333,234,"F-open-W",494099,494333,"chrII"
"chrII","YBR130C (SHE3)","-",495479,495317,495626,309,"W-open-W",495317,495626,"chrII"
"chrII","YBR131W (CCZ1 CVT16)","+",499352,499423,499251,172,"F-close-F",499251,499423,"chrII"
"chrII","YBR132C (AGP2)","-",499349,499251,499423,172,"F-close-F",499251,499423,"chrII"
"chrII","YBR133C (HSL7)","-",501663,501562,501862,300,"W-open-W",501562,501862,"chrII"
"chrII","YBR135W (CKS1)","+",505497,505697,505444,253,"F-open-W",505444,505697,"chrII"
"chrII","YBR136W (MEC1 ESR1 SAD3)","+",512970,513013,512725,288,"W-open-F",512725,513013,"chrII"
"chrII","YBR137W","+",513718,513798,513670,128,"W-close-F",513670,513798,"chrII"
"chrII","YBR138C (HDR1)","-",513613,513516,513670,154,"W-close-F",513516,513670,"chrII"
"chrII","YBR139W","+",517354,517404,517162,242,"F-open-W",517162,517404,"chrII"
"chrII","YBR140C (IRA1 GLC1 PPD1)","-",517247,517162,517404,242,"W-open-F",517162,517404,"chrII"
"chrII","YBR141C","-",526922,526881,527152,271,"W-open-W",526881,527152,"chrII"
"chrII","YBR141W-A","+",527747,527840,527665,175,"W-close-W",527665,527840,"chrII"
"chrII","YBR142W (MAK5)","+",530815,530936,530688,248,"W-open-F",530688,530936,"chrII"
"chrII","YBR143C (SUP45 SAL4 SUP1 SUP47)","-",530730,530688,530936,248,"F-open-W",530688,530936,"chrII"
"chrII","YBR145W (ADH5)","+",534918,534961,534765,196,"W-close-W",534765,534961,"chrII"
"chrII","YBR146W (MRPS9)","+",536298,536455,536258,197,"F-close-W",536258,536455,"chrII"
"chrII","YBR147W (RTC2 RRT11)","+",537511,537649,537469,180,"W-close-F",537469,537649,"chrII"
"chrII","YBR148W (YSW1)","+",539820,539978,539683,295,"F-open-F",539683,539978,"chrII"
"chrII","YBR149W (ARA1)","+",541145,541329,541125,204,"F-close-F",541125,541329,"chrII"
"chrII","YBR150C (TBS1)","-",541160,541125,541329,204,"F-close-F",541125,541329,"chrII"
"chrII","YBR151W (APD1)","+",546108,546158,545963,195,"W-close-W",545963,546158,"chrII"
"chrII","YBR153W (RIB7)","+",548366,548416,548209,207,"F-close-W",548209,548416,"chrII"
"chrII","YBR154C (RPB5)","-",548272,548209,548416,207,"W-close-F",548209,548416,"chrII"
"chrII","YBR155W (CNS1)","+",551015,551151,550918,233,"F-open-F",550918,551151,"chrII"
"chrII","YBR156C (SLI15)","-",550927,550918,551151,233,"F-open-F",550918,551151,"chrII"
"chrII","YBR157C (ICS2)","-",553414,553193,553471,278,"W-open-W",553193,553471,"chrII"
"chrII","YBR158W (AMN1 CST13 ICS4)","+",558353,558429,558261,168,"W-close-W",558261,558429,"chrII"
"chrII","YBR159W (IFA38)","+",559894,560034,559744,290,"F-open-W",559744,560034,"chrII"
"chrII","YBR160W (CDC28 CDK1 HSL5 SRM5)","+",561068,NA,NA,NA,"+1_missing",560981,561383,"chrII"
"chrII","YBR161W (CSH1)","+",562904,562957,562797,160,"W-close-F",562797,562957,"chrII"
"chrII","YBR162C (TOS1)","-",562927,562797,562957,160,"F-close-W",562797,562957,"chrII"
"chrII","YBR162W-A (YSY6)","+",565530,565669,565414,255,"W-open-W",565414,565669,"chrII"
"chrII","YBR163W (EXO5 DEM1)","+",567544,567558,567315,243,"W-open-F",567315,567558,"chrII"
"chrII","YBR164C (ARL1 DLP2)","-",567738,567658,567826,168,"W-close-F",567658,567826,"chrII"
"chrII","YBR165W (UBS1)","+",569823,569892,569775,117,"F-overlap-F",569775,569892,"chrII"
"chrII","YBR166C (TYR1)","-",569741,569673,569775,102,"F-overlap-F",569673,569775,"chrII"
"chrII","YBR167C (POP7 RPP2)","-",571373,571202,571448,246,"F-open-W",571202,571448,"chrII"
"chrII","YBR168W (PEX32)","+",573768,573822,573715,107,"F-overlap-F",573715,573822,"chrII"
"chrII","YBR169C (SSE2)","-",573737,573715,573822,107,"F-overlap-F",573715,573822,"chrII"
"chrII","YBR170C (NPL4 HRD4)","-",576214,576075,576378,303,"F-open-F",576075,576378,"chrII"
"chrII","YBR171W (SEC66 HSS1 SEC71)","+",579109,579209,578886,323,"W-open-W",578886,579209,"chrII"
"chrII","YBR172C (SMY2)","-",579012,578886,579209,323,"W-open-W",578886,579209,"chrII"
"chrII","YBR173C (UMP1 RNS2)","-",581579,581436,581710,274,"W-open-W",581436,581710,"chrII"
"chrII","YBR175W (SWD3 CPS30 SAF35)","+",583458,583641,583415,226,"W-open-W",583415,583641,"chrII"
"chrII","YBR176W (ECM31)","+",584803,584838,584711,127,"F-close-F",584711,584838,"chrII"
"chrII","YBR177C (EHT1)","-",584680,584608,584711,103,"F-overlap-F",584608,584711,"chrII"
"chrII","YBR178W","+",586573,586569,586345,224,"F-open-F",586345,586569,"chrII"
"chrII","YBR179C (FZO1)","-",586476,586345,586569,224,"F-open-F",586345,586569,"chrII"
"chrII","YBR181C (RPS6B LPG18 RPS101 RPS102)","-",591618,591616,591766,150,"F-close-F",591616,591766,"chrII"
"chrII","YBR182C (SMP1)","-",593216,NA,NA,NA,"+1_missing",592770,593258,"chrII"
"chrII","YBR182C-A","-",595204,595019,595351,332,"F-open-W",595019,595351,"chrII"
"chrII","YBR183W (YPC1)","+",597146,597151,596964,187,"W-close-F",596964,597151,"chrII"
"chrII","YBR185C (MBA1)","-",598944,598958,599135,177,"W-close-F",598958,599135,"chrII"
"chrII","YBR186W (PCH2)","+",602523,602535,NA,NA,"-1_missing",602207,602535,"chrII"
"chrII","YBR187W (GDT1)","+",603630,603656,603459,197,"F-close-W",603459,603656,"chrII"
"chrII","YBR188C (NTC20)","-",603496,603459,603656,197,"W-close-F",603459,603656,"chrII"
"chrII","YBR189W (RPS9B RPS13A SUP46)","+",605573,605642,605447,195,"W-close-W",605447,605642,"chrII"
"chrII","YBR191W (RPL21A URP1)","+",607246,607317,607070,247,"W-open-F",607070,607317,"chrII"
"chrII","YBR192W (RIM2 PYT1)","+",609042,609185,609005,180,"F-close-W",609005,609185,"chrII"
"chrII","YBR193C (MED8)","-",608819,608683,608877,194,"F-close-F",608683,608877,"chrII"
"chrII","YBR194W (AIM4 SOY1)","+",610618,610658,610470,188,"W-close-W",610470,610658,"chrII"
"chrII","YBR195C (MSI1 CAC3)","-",610487,610470,610658,188,"W-close-W",610470,610658,"chrII"
"chrII","YBR196C (PGI1 CDC30)","-",612072,612028,612130,102,"F-overlap-F",612028,612130,"chrII"
"chrII","YBR196C-A","-",613951,613935,614093,158,"F-close-F",613935,614093,"chrII"
"chrII","YBR197C","-",614746,614646,614840,194,"F-close-F",614646,614840,"chrII"
"chrII","YBR198C (TAF5 TAF90)","-",616043,615827,616101,274,"W-open-W",615827,616101,"chrII"
"chrII","YBR199W (KTR4)","+",620452,620581,620378,203,"F-close-W",620378,620581,"chrII"
"chrII","YBR200W (BEM1 SRO1)","+",622749,622909,622642,267,"F-open-F",622642,622909,"chrII"
"chrII","YBR201C-A","-",624254,624148,624321,173,"W-close-W",624148,624321,"chrII"
"chrII","YBR201W (DER1)","+",624335,624321,624148,173,"W-close-W",624148,624321,"chrII"
"chrII","YBR202W (MCM7 CDC47)","+",628486,NA,NA,NA,"+1_missing",628382,628922,"chrII"
"chrII","YBR203W (COS111)","+",632150,632244,631925,319,"F-open-F",631925,632244,"chrII"
"chrII","YBR204C","-",632032,631925,632244,319,"F-open-F",631925,632244,"chrII"
"chrII","YBR205W (KTR3)","+",634881,635116,634846,270,"W-open-W",634846,635116,"chrII"
"chrII","YBR206W","+",635016,635116,634846,270,"W-open-W",634846,635116,"chrII"
"chrII","YBR207W (FTH1)","+",636660,636697,636626,71,"F-overlap-F",636626,636697,"chrII"
"chrII","YBR208C (DUR1%2C2 DUR80)","-",636572,636457,636626,169,"F-close-W",636457,636626,"chrII"
"chrII","YBR210W (ERV15)","+",645991,646021,645909,112,"F-overlap-F",645909,646021,"chrII"
"chrII","YBR211C (AME1 ARP100)","-",646097,646021,646249,228,"F-open-F",646021,646249,"chrII"
"chrII","YBR212W (NGR1 RBP1)","+",650110,650339,650048,291,"W-open-W",650048,650339,"chrII"
"chrII","YBR213W (MET8)","+",651388,651384,NA,NA,"-1_missing",651062,651384,"chrII"
"chrII","YBR214W (SDS24)","+",653182,653351,653073,278,"F-open-W",653073,653351,"chrII"
"chrII","YBR215W (HPC2)","+",655435,655489,655348,141,"F-close-F",655348,655489,"chrII"
"chrII","YBR216C (YBP1)","-",655348,655348,655489,141,"F-close-F",655348,655489,"chrII"
"chrII","YBR217W (ATG12 APG12)","+",658701,658822,658677,145,"F-close-F",658677,658822,"chrII"
"chrII","YBR218C (PYC2)","-",658591,658506,658677,171,"F-close-W",658506,658677,"chrII"
"chrII","YBR220C","-",662904,662895,663102,207,"W-close-W",662895,663102,"chrII"
"chrII","YBR221C (PDB1)","-",664913,664706,664947,241,"W-open-W",664706,664947,"chrII"
"chrII","YBR221W-A","+",666978,667043,666879,164,"W-close-F",666879,667043,"chrII"
"chrII","YBR222C (PCS60 FAT2)","-",666606,666443,666721,278,"W-open-W",666443,666721,"chrII"
"chrII","YBR223C (TDP1)","-",668420,668358,668652,294,"F-open-W",668358,668652,"chrII"
"chrII","YBR225W","+",673621,673670,673569,101,"F-overlap-F",673569,673670,"chrII"
"chrII","YBR227C (MCX1)","-",673461,673361,673569,208,"F-close-F",673361,673569,"chrII"
"chrII","YBR228W (SLX1)","+",676340,676383,676187,196,"W-close-F",676187,676383,"chrII"
"chrII","YBR229C (ROT2 GLS2)","-",676226,676187,676383,196,"F-close-W",676187,676383,"chrII"
"chrII","YBR230C (OM14)","-",679451,679209,679486,277,"W-open-W",679209,679486,"chrII"
"chrII","YBR230W-A","+",680700,680786,680511,275,"F-open-F",680511,680786,"chrII"
"chrII","YBR231C (SWC5 AOR1)","-",682124,681840,682249,409,"W-open-W",681840,682249,"chrII"
"chrII","YBR233W (PBP2 HEK1)","+",684819,684996,684760,236,"F-open-W",684760,684996,"chrII"
"chrII","YBR233W-A (DAD3)","+",685473,685518,685330,188,"W-close-W",685330,685518,"chrII"
"chrII","YBR234C (ARC40)","-",685372,685330,685518,188,"W-close-W",685330,685518,"chrII"
"chrII","YBR235W","+",690354,690342,690176,166,"F-close-F",690176,690342,"chrII"
"chrII","YBR236C (ABD1)","-",690232,690176,690342,166,"F-close-F",690176,690342,"chrII"
"chrII","YBR237W (PRP5 RNA5)","+",694611,694742,694520,222,"F-open-F",694520,694742,"chrII"
"chrII","YBR238C","-",694974,694910,695037,127,"F-close-F",694910,695037,"chrII"
"chrII","YBR239C (ERT1)","-",698265,698196,698439,243,"F-open-F",698196,698439,"chrII"
"chrII","YBR240C (THI2 PHO6 phoF)","-",700265,700283,700501,218,"W-open-F",700283,700501,"chrII"
"chrII","YBR241C","-",702522,702461,702650,189,"W-close-F",702461,702650,"chrII"
"chrII","YBR242W","+",705455,705528,705406,122,"F-close-F",705406,705528,"chrII"
"chrII","YBR243C (ALG7 TUR1)","-",705288,705210,705406,196,"F-close-W",705210,705406,"chrII"
"chrII","YBR244W (GPX2 AMI1)","+",708136,708229,708048,181,"W-close-W",708048,708229,"chrII"
"chrII","YBR246W (RRT2)","+",712881,712896,712721,175,"W-close-F",712721,712896,"chrII"
"chrII","YBR247C (ENP1 MEG1)","-",712887,712896,713015,119,"F-overlap-F",712896,713015,"chrII"
"chrII","YBR248C (HIS7)","-",714727,714721,714908,187,"W-close-W",714721,714908,"chrII"
"chrII","YBR249C (ARO4)","-",716765,716503,716791,288,"W-open-W",716503,716791,"chrII"
"chrII","YBR250W (SPO23)","+",720735,720782,720583,199,"W-close-W",720583,720782,"chrII"
"chrII","YBR251W (MRPS5)","+",722403,722396,722230,166,"W-close-W",722230,722396,"chrII"
"chrII","YBR252W (DUT1)","+",723127,723264,723057,207,"F-close-W",723057,723264,"chrII"
"chrII","YBR253W (SRB6 MED22)","+",723663,723765,723585,180,"W-close-W",723585,723765,"chrII"
"chrII","YBR254C (TRS20)","-",723593,723585,723765,180,"W-close-W",723585,723765,"chrII"
"chrII","YBR255C-A","-",726519,726514,726704,190,"W-close-W",726514,726704,"chrII"
"chrII","YBR255W (MTC4)","+",726683,726704,726514,190,"W-close-W",726514,726704,"chrII"
"chrII","YBR256C (RIB5)","-",727322,727307,727487,180,"W-close-W",727307,727487,"chrII"
"chrII","YBR257W (POP4)","+",729790,729801,729625,176,"W-close-W",729625,729801,"chrII"
"chrII","YBR258C (SHG1 CPS15)","-",729662,729625,729801,176,"W-close-W",729625,729801,"chrII"
"chrII","YBR259W","+",732590,732617,732437,180,"W-close-W",732437,732617,"chrII"
"chrII","YBR260C (RGD1)","-",732507,732437,732617,180,"W-close-W",732437,732617,"chrII"
"chrII","YBR261C (TAE1 NTM1)","-",734704,734600,734843,243,"W-open-W",734600,734843,"chrII"
"chrII","YBR262C (AIM5 FMP51)","-",735602,735510,735700,190,"W-close-W",735510,735700,"chrII"
"chrII","YBR263W (SHM1 SHMT1 TMP3)","+",737829,737813,737642,171,"W-close-F",737642,737813,"chrII"
"chrII","YBR264C (YPT10)","-",737733,737642,737813,171,"F-close-W",737642,737813,"chrII"
"chrII","YBR265W (TSC10)","+",739677,739864,739615,249,"W-open-W",739615,739864,"chrII"
"chrII","YBR266C (SLM6)","-",739816,739615,739864,249,"W-open-W",739615,739864,"chrII"
"chrII","YBR267W (REI1)","+",741142,741341,741078,263,"W-open-W",741078,741341,"chrII"
"chrII","YBR268W (MRPL37)","+",741725,741888,741638,250,"W-open-W",741638,741888,"chrII"
"chrII","YBR269C (FMP21)","-",742004,741888,742051,163,"W-close-W",741888,742051,"chrII"
"chrII","YBR270C (BIT2)","-",742721,742519,742831,312,"W-open-W",742519,742831,"chrII"
"chrII","YBR271W","+",746209,746266,746144,122,"F-close-F",746144,746266,"chrII"
"chrII","YBR272C (HSM3)","-",746172,746144,746266,122,"F-close-F",746144,746266,"chrII"
"chrII","YBR273C (UBX7 CUI3)","-",747954,747767,747977,210,"W-close-W",747767,747977,"chrII"
"chrII","YBR274W (CHK1)","+",751334,751427,751224,203,"F-close-F",751224,751427,"chrII"
"chrII","YBR275C (RIF1)","-",751252,751224,751427,203,"F-close-F",751224,751427,"chrII"
"chrII","YBR276C (PPS1)","-",757550,757415,757607,192,"W-close-W",757415,757607,"chrII"
"chrII","YBR277C","-",760139,760075,760306,231,"W-open-W",760075,760306,"chrII"
"chrII","YBR278W (DPB3)","+",760991,761269,760848,421,"W-open-W",760848,761269,"chrII"
"chrII","YBR279W (PAF1)","+",762741,762778,762710,68,"F-overlap-F",762710,762778,"chrII"
"chrII","YBR280C (SAF1)","-",762619,762564,762710,146,"F-close-W",762564,762710,"chrII"
"chrII","YBR281C (DUG2)","-",764860,764700,764975,275,"W-open-W",764700,764975,"chrII"
"chrII","YBR282W (MRPL27)","+",768768,768752,768593,159,"W-close-F",768593,768752,"chrII"
"chrII","YBR283C (SSH1)","-",768791,768752,768939,187,"F-close-F",768752,768939,"chrII"
"chrII","YBR284W","+",773843,773977,773819,158,"F-close-W",773819,773977,"chrII"
"chrII","YBR285W","+",774497,774742,774294,448,"W-open-W",774294,774742,"chrII"
"chrII","YBR286W (APE3 APY1)","+",776385,776565,776243,322,"W-open-W",776243,776565,"chrII"
"chrII","YBR287W (ZSP1)","+",777974,778003,777790,213,"F-close-F",777790,778003,"chrII"
"chrII","YBR288C (APM3 YKS6)","-",777927,777790,778003,213,"F-close-F",777790,778003,"chrII"
"chrII","YBR289W (SNF5 HAF4 SWI10 TYE4)","+",782442,782631,782360,271,"W-open-W",782360,782631,"chrII"
"chrII","YBR290W (BSD2)","+",783664,783744,783574,170,"W-close-W",783574,783744,"chrII"
"chrII","YBR291C (CTP1)","-",783604,783574,783744,170,"W-close-W",783574,783744,"chrII"
"chrII","YBR293W (VBA2)","+",788651,788697,788512,185,"W-close-W",788512,788697,"chrII"
"chrII","YBR294W (SUL1 SFP2)","+",791892,791887,791725,162,"F-close-F",791725,791887,"chrII"
"chrII","YBR295W (PCA1 CAD2 PAY2)","+",796635,796701,796458,243,"F-open-F",796458,796701,"chrII"
"chrII","YBR296C (PHO89 ITN1)","-",796558,796458,796701,243,"F-open-F",796458,796701,"chrII"
"chrII","YBR297W (MAL33 MAL3R MALR)","+",802166,802189,802106,83,"F-overlap-F",802106,802189,"chrII"
"chrII","YBR298C (MAL31 MAL3T MALT)","-",802538,802410,802576,166,"W-close-F",802410,802576,"chrII"
"chrII","YBR299W (MAL32 MAL3S MALS)","+",807234,NA,NA,NA,"+1_missing",805332,807553,"chrII"
"chrIII","YCL001W (RER1)","+",112563,112561,112464,97,"F-overlap-F",112464,112561,"chrIII"
"chrIII","YCL001W-A","+",114228,114213,114025,188,"W-close-W",114025,114213,"chrIII"
"chrIII","YCL002C","-",110634,110647,110815,168,"F-close-F",110647,110815,"chrIII"
"chrIII","YCL004W (PGS1 PEL1 YCL003W)","+",110747,110815,110647,168,"F-close-F",110647,110815,"chrIII"
"chrIII","YCL005W (LDB16)","+",108928,109060,108850,210,"F-close-W",108850,109060,"chrIII"
"chrIII","YCL005W-A (VMA9 CWH36 LDB10)","+",107528,107585,107397,188,"W-close-W",107397,107585,"chrIII"
"chrIII","YCL008C (STP22 VPL15 VPS23)","-",105564,105527,105803,276,"W-open-W",105527,105803,"chrIII"
"chrIII","YCL009C (ILV6)","-",104490,104335,104634,299,"W-open-W",104335,104634,"chrIII"
"chrIII","YCL010C (SGF29)","-",103525,103334,103630,296,"W-open-W",103334,103630,"chrIII"
"chrIII","YCL011C (GBP2 RLF6)","-",101965,101766,102053,287,"W-open-W",101766,102053,"chrIII"
"chrIII","YCL012C (YCL011C-A)","-",101190,101119,101310,191,"F-close-W",101119,101310,"chrIII"
"chrIII","YCL014W (BUD3 YCL012W)","+",101322,101310,101119,191,"W-close-F",101119,101310,"chrIII"
"chrIII","YCL016C (DCC1)","-",94479,94314,94620,306,"F-open-W",94314,94620,"chrIII"
"chrIII","YCL017C (NFS1 SPL1)","-",92625,92628,92735,107,"F-overlap-F",92628,92735,"chrIII"
"chrIII","YCL018W (LEU2)","+",92494,92558,92365,193,"F-close-F",92365,92558,"chrIII"
"chrIII","YCL021W-A","+",84211,NA,NA,NA,"+1_missing",83989,91209,"chrIII"
"chrIII","YCL024W (KCC4)","+",82365,NA,NA,NA,"+1_missing",82327,83196,"chrIII"
"chrIII","YCL025C (AGP1 YCC5)","-",75936,75766,76068,302,"W-open-W",75766,76068,"chrIII"
"chrIII","YCL026C-A (FRM2 YCLX08C)","-",74490,74452,74694,242,"W-open-W",74452,74694,"chrIII"
"chrIII","YCL026C-B (HBN1 YCL027C-A)","-",73343,73323,73531,208,"F-close-F",73323,73531,"chrIII"
"chrIII","YCL027W (FUS1)","+",73461,73531,73323,208,"F-close-F",73323,73531,"chrIII"
"chrIII","YCL028W (RNQ1 %5BPIN(%2B)%5D)","+",71491,71492,71303,189,"W-close-F",71303,71492,"chrIII"
"chrIII","YCL029C (BIK1 ARM5 PAC14)","-",68353,68221,68380,159,"F-close-W",68221,68380,"chrIII"
"chrIII","YCL030C (HIS4)","-",65821,65826,66012,186,"W-close-W",65826,66012,"chrIII"
"chrIII","YCL031C (RRP7)","-",64560,64435,64629,194,"F-close-W",64435,64629,"chrIII"
"chrIII","YCL032W (STE50)","+",64581,64629,64435,194,"W-close-F",64435,64629,"chrIII"
"chrIII","YCL033C (MXR2 MSRB)","-",62701,62672,62758,86,"F-overlap-F",62672,62758,"chrIII"
"chrIII","YCL034W (LSB5)","+",62799,62880,62758,122,"F-close-W",62758,62880,"chrIII"
"chrIII","YCL035C (GRX1)","-",60725,60693,60864,171,"W-close-W",60693,60864,"chrIII"
"chrIII","YCL036W (GFD2 YCD6)","+",60822,60864,60693,171,"W-close-W",60693,60864,"chrIII"
"chrIII","YCL037C (SRO9)","-",56819,56829,56978,149,"W-close-F",56829,56978,"chrIII"
"chrIII","YCL038C (ATG22 AUT4)","-",54863,54802,55034,232,"F-open-W",54802,55034,"chrIII"
"chrIII","YCL039W (GID7 MOH2)","+",54924,55034,54802,232,"W-open-F",54802,55034,"chrIII"
"chrIII","YCL040W (GLK1 HOR3)","+",52518,52672,52243,429,"F-open-W",52243,52672,"chrIII"
"chrIII","YCL041C","-",49580,49439,49604,165,"F-close-F",49439,49604,"chrIII"
"chrIII","YCL042W","+",51453,51526,51365,161,"F-close-W",51365,51526,"chrIII"
"chrIII","YCL043C (PDI1 MFP1 TRG1)","-",48557,48399,48810,411,"F-open-W",48399,48810,"chrIII"
"chrIII","YCL044C (MGR1)","-",46937,46894,47181,287,"W-open-W",46894,47181,"chrIII"
"chrIII","YCL045C (EMC1)","-",44562,44417,44623,206,"F-close-W",44417,44623,"chrIII"
"chrIII","YCL047C","-",43569,43523,43708,185,"W-close-W",43523,43708,"chrIII"
"chrIII","YCL048W (SPS22)","+",43666,43708,43523,185,"W-close-W",43523,43708,"chrIII"
"chrIII","YCL048W-A","+",41967,42115,41672,443,"W-open-W",41672,42115,"chrIII"
"chrIII","YCL049C","-",39648,39396,39861,465,"W-open-W",39396,39861,"chrIII"
"chrIII","YCL050C (APA1 DTP1)","-",37728,37699,37882,183,"F-close-F",37699,37882,"chrIII"
"chrIII","YCL051W (LRE1)","+",37733,37882,37699,183,"F-close-F",37699,37882,"chrIII"
"chrIII","YCL052C (PBN1)","-",33973,33885,34035,150,"F-close-F",33885,34035,"chrIII"
"chrIII","YCL054W (SPB1)","+",34078,34139,34035,104,"F-overlap-F",34035,34139,"chrIII"
"chrIII","YCL055W (KAR4)","+",29058,29100,28907,193,"W-close-W",28907,29100,"chrIII"
"chrIII","YCL056C","-",26901,26844,26982,138,"W-close-W",26844,26982,"chrIII"
"chrIII","YCL057C-A","-",24003,23956,24136,180,"W-close-F",23956,24136,"chrIII"
"chrIII","YCL057W (PRD1)","+",27021,27156,26982,174,"W-close-W",26982,27156,"chrIII"
"chrIII","YCL058W-A (ADF1)","+",23993,24136,23956,180,"F-close-W",23956,24136,"chrIII"
"chrIII","YCL059C (KRR1)","-",22323,22102,22514,412,"W-open-W",22102,22514,"chrIII"
"chrIII","YCL061C (MRC1 YCL060C)","-",18649,18591,18928,337,"F-open-F",18591,18928,"chrIII"
"chrIII","YCL063W (VAC17 YCL062W)","+",18714,18928,18591,337,"F-open-F",18591,18928,"chrIII"
"chrIII","YCL064C (CHA1)","-",15688,15610,15830,220,"F-open-F",15610,15830,"chrIII"
"chrIII","YCL066W (HMLALPHA1 ALPHA1)","+",13921,NA,NA,NA,"+1_missing",9713,14877,"chrIII"
"chrIII","YCR001W","+",116226,116230,116153,77,"F-overlap-F",116153,116230,"chrIII"
"chrIII","YCR002C (CDC10)","-",117280,117245,117420,175,"W-close-W",117245,117420,"chrIII"
"chrIII","YCR003W (MRPL32)","+",119276,119319,119148,171,"W-close-W",119148,119319,"chrIII"
"chrIII","YCR004C (YCP4)","-",119390,119319,119660,341,"W-open-W",119319,119660,"chrIII"
"chrIII","YCR005C (CIT2)","-",120821,120755,120965,210,"W-close-F",120755,120965,"chrIII"
"chrIII","YCR006C","-",122375,122318,122520,202,"W-close-F",122318,122520,"chrIII"
"chrIII","YCR007C","-",125906,125810,125978,168,"W-close-W",125810,125978,"chrIII"
"chrIII","YCR008W (SAT4 HAL4)","+",130550,130609,130391,218,"F-open-F",130391,130609,"chrIII"
"chrIII","YCR009C (RVS161 END6 FUS7 SPE161)","-",130574,130391,130609,218,"F-open-F",130391,130609,"chrIII"
"chrIII","YCR010C (ADY2 ATO1)","-",132091,132018,132184,166,"F-close-F",132018,132184,"chrIII"
"chrIII","YCR011C (ADP1)","-",133667,133485,133785,300,"W-open-F",133485,133785,"chrIII"
"chrIII","YCR012W (PGK1)","+",139154,139218,138877,341,"F-open-F",138877,139218,"chrIII"
"chrIII","YCR013C","-",137886,137826,137982,156,"F-close-W",137826,137982,"chrIII"
"chrIII","YCR015C","-",141136,141152,141329,177,"W-close-F",141152,141329,"chrIII"
"chrIII","YCR016W","+",144675,144721,144622,99,"F-overlap-F",144622,144721,"chrIII"
"chrIII","YCR017C (CWH43)","-",144583,144500,144622,122,"F-close-F",144500,144622,"chrIII"
"chrIII","YCR018C (SRD1)","-",148199,148123,148295,172,"W-close-F",148123,148295,"chrIII"
"chrIII","YCR019W (MAK32)","+",154042,154070,153993,77,"F-overlap-F",153993,154070,"chrIII"
"chrIII","YCR020C (PET18 HIT2)","-",153927,153881,153993,112,"F-overlap-F",153881,153993,"chrIII"
"chrIII","YCR020C-A (MAK31 LSM9 NAA38 SMX1)","-",154672,154529,154718,189,"F-close-W",154529,154718,"chrIII"
"chrIII","YCR020W-B (HTL1)","+",156037,156166,155861,305,"W-open-F",155861,156166,"chrIII"
"chrIII","YCR021C (HSP30 YRO1)","-",155930,155861,156166,305,"F-open-W",155861,156166,"chrIII"
"chrIII","YCR022C","-",157141,157106,157198,92,"F-overlap-F",157106,157198,"chrIII"
"chrIII","YCR023C","-",158297,158295,158427,132,"F-close-F",158295,158427,"chrIII"
"chrIII","YCR024C (SLM5)","-",160602,160404,160665,261,"W-open-W",160404,160665,"chrIII"
"chrIII","YCR024C-A (PMP1)","-",162722,162578,162796,218,"F-open-F",162578,162796,"chrIII"
"chrIII","YCR024C-B","-",162409,162186,162578,392,"F-open-W",162186,162578,"chrIII"
"chrIII","YCR025C","-",163285,163065,163427,362,"W-open-F",163065,163427,"chrIII"
"chrIII","YCR026C (NPP1)","-",163901,163909,164054,145,"F-close-F",163909,164054,"chrIII"
"chrIII","YCR027C (RHB1 RSG1)","-",166754,166600,166865,265,"W-open-W",166600,166865,"chrIII"
"chrIII","YCR028C (FEN2)","-",170614,170625,170707,82,"F-overlap-W",170625,170707,"chrIII"
"chrIII","YCR028C-A (RIM1)","-",172783,172766,172935,169,"W-close-W",172766,172935,"chrIII"
"chrIII","YCR030C (SYP1 YCR029C-A)","-",173653,173438,173701,263,"W-open-W",173438,173701,"chrIII"
"chrIII","YCR031C (RPS14A CRY1 RPL59)","-",177388,177300,177426,126,"F-close-W",177300,177426,"chrIII"
"chrIII","YCR032W (BPH1)","+",186104,186325,185985,340,"W-open-W",185985,186325,"chrIII"
"chrIII","YCR033W (SNT1)","+",190345,190602,190315,287,"F-open-W",190315,190602,"chrIII"
"chrIII","YCR034W (FEN1 ELO2 GNS1 VBM2)","+",191798,191867,191569,298,"W-open-F",191569,191867,"chrIII"
"chrIII","YCR035C (RRP43)","-",191681,191569,191867,298,"F-open-W",191569,191867,"chrIII"
"chrIII","YCR036W (RBK1)","+",194381,194480,194211,269,"F-open-W",194211,194480,"chrIII"
"chrIII","YCR037C (PHO87)","-",194323,194211,194480,269,"W-open-F",194211,194480,"chrIII"
"chrIII","YCR042C (TAF2 TAF150 TSM1)","-",201146,201138,201297,159,"W-close-W",201138,201297,"chrIII"
"chrIII","YCR043C","-",206095,206039,206139,100,"F-overlap-F",206039,206139,"chrIII"
"chrIII","YCR044C (PER1 COS16)","-",206790,206629,206902,273,"W-open-W",206629,206902,"chrIII"
"chrIII","YCR045C (RRT12 OSW3)","-",208073,207905,208175,270,"W-open-W",207905,208175,"chrIII"
"chrIII","YCR045W-A","+",209788,209906,209656,250,"W-open-F",209656,209906,"chrIII"
"chrIII","YCR046C (IMG1)","-",209807,209656,209906,250,"F-open-W",209656,209906,"chrIII"
"chrIII","YCR047C (BUD23)","-",210535,210402,210611,209,"F-close-W",210402,210611,"chrIII"
"chrIII","YCR048W (ARE1 SAT2)","+",213956,214102,213813,289,"W-open-W",213813,214102,"chrIII"
"chrIII","YCR051W","+",214879,215017,214745,272,"W-open-W",214745,215017,"chrIII"
"chrIII","YCR052W (RSC6)","+",216655,216670,216367,303,"W-open-W",216367,216670,"chrIII"
"chrIII","YCR053W (THR4)","+",218350,218369,218127,242,"F-open-F",218127,218369,"chrIII"
"chrIII","YCR054C (CTR86)","-",218196,218127,218369,242,"F-open-F",218127,218369,"chrIII"
"chrIII","YCR057C (PWP2 UTP1 YCR055C YCR058C)","-",220344,220331,220525,194,"W-close-W",220331,220525,"chrIII"
"chrIII","YCR059C (YIH1)","-",223273,223233,223533,300,"W-open-W",223233,223533,"chrIII"
"chrIII","YCR060W (TAH1)","+",224858,225017,224766,251,"F-open-W",224766,225017,"chrIII"
"chrIII","YCR061W (YCR062W)","+",227816,NA,NA,NA,"+1_missing",227788,228118,"chrIII"
"chrIII","YCR063W (BUD31 CWC14)","+",229272,229292,229131,161,"W-close-W",229131,229292,"chrIII"
"chrIII","YCR064C","-",228086,227788,228118,330,"F-open-W",227788,228118,"chrIII"
"chrIII","YCR065W (HCM1)","+",231330,231502,231295,207,"F-close-W",231295,231502,"chrIII"
"chrIII","YCR066W (RAD18)","+",233128,233116,232959,157,"F-close-F",232959,233116,"chrIII"
"chrIII","YCR067C (SED4)","-",233034,232959,233116,157,"F-close-F",232959,233116,"chrIII"
"chrIII","YCR068W (ATG15 AUT5 CVT17)","+",238890,238962,238648,314,"W-open-W",238648,238962,"chrIII"
"chrIII","YCR069W (CPR4 CYP4 SCC3 YCR070W)","+",240132,240188,239990,198,"F-close-W",239990,240188,"chrIII"
"chrIII","YCR071C (IMG2)","-",240024,239990,240188,198,"W-close-F",239990,240188,"chrIII"
"chrIII","YCR072C (RSA4)","-",240701,240538,240802,264,"W-open-W",240538,240802,"chrIII"
"chrIII","YCR073C (SSK22)","-",242516,242330,242632,302,"W-open-W",242330,242632,"chrIII"
"chrIII","YCR073W-A (SOL2 YCRX13W)","+",248029,248104,247819,285,"F-open-W",247819,248104,"chrIII"
"chrIII","YCR075C (ERS1)","-",247889,247819,248104,285,"W-open-F",247819,248104,"chrIII"
"chrIII","YCR075W-A","+",249290,249353,249166,187,"W-close-W",249166,249353,"chrIII"
"chrIII","YCR076C","-",249188,249166,249353,187,"W-close-W",249166,249353,"chrIII"
"chrIII","YCR077C (PAT1 MRT1)","-",250100,249985,250233,248,"F-open-W",249985,250233,"chrIII"
"chrIII","YCR079W (PTC6 AUP1 PPP2)","+",254299,254417,254160,257,"W-open-W",254160,254417,"chrIII"
"chrIII","YCR081W (SRB8 GIG1 MED12 NUT6 SSN5 YCR080W)","+",258847,258883,258617,266,"W-open-W",258617,258883,"chrIII"
"chrIII","YCR082W (AHC2)","+",259376,259395,259208,187,"W-close-W",259208,259395,"chrIII"
"chrIII","YCR083W (TRX3)","+",260084,260140,259934,206,"W-close-W",259934,260140,"chrIII"
"chrIII","YCR084C (TUP1 AAR1 AER2 AMM1 CRT4 CYC9 FLK1 ROX4 SFL2 UMR7)","-",260216,260140,260384,244,"F-open-W",260140,260384,"chrIII"
"chrIII","YCR086W (CSM1)","+",264483,264654,264448,206,"W-close-W",264448,264654,"chrIII"
"chrIII","YCR087C-A","-",263943,263914,264004,90,"F-overlap-F",263914,264004,"chrIII"
"chrIII","YCR088W (ABP1)","+",266979,267161,266914,247,"W-open-W",266914,267161,"chrIII"
"chrIII","YCR089W (FIG2)","+",272320,272343,272150,193,"W-close-F",272150,272343,"chrIII"
"chrIII","YCR090C","-",272239,272150,272343,193,"F-close-W",272150,272343,"chrIII"
"chrIII","YCR091W (KIN82 FPK2)","+",277017,277067,276979,88,"F-overlap-F",276979,277067,"chrIII"
"chrIII","YCR092C (MSH3)","-",276602,276597,276743,146,"F-close-F",276597,276743,"chrIII"
"chrIII","YCR093W (CDC39 NOT1 ROS1 SMD6)","+",286548,286755,286448,307,"F-open-W",286448,286755,"chrIII"
"chrIII","YCR094W (CDC50)","+",288211,288258,288096,162,"F-close-W",288096,288258,"chrIII"
"chrIII","YCR095C (OCA4)","-",288114,288096,288258,162,"W-close-F",288096,288258,"chrIII"
"chrIII","YCR095W-A","+",291198,291296,291105,191,"F-close-F",291105,291296,"chrIII"
"chrIII","YCR097W (HMRA1 YCR097WB)","+",294348,294344,294190,154,"F-close-W",294190,294344,"chrIII"
"chrIII","YCR098C (GIT1)","-",296791,296763,296833,70,"F-overlap-F",296763,296833,"chrIII"
"chrIII","YCR102C","-",304096,304054,304262,208,"F-close-W",304054,304262,"chrIII"
"chrIII","YCR105W (ADH7 ADHVII)","+",310198,310195,309995,200,"F-close-F",309995,310195,"chrIII"
"chrIII","YCR106W (RDS1)","+",313784,313835,313744,91,"F-overlap-F",313744,313835,"chrIII"
"chrIV","YDL001W (RMD1)","+",449392,449581,449341,240,"F-open-F",449341,449581,"chrIV"
"chrIV","YDL002C (NHP10 HMO2)","-",446682,446622,446786,164,"W-close-F",446622,446786,"chrIV"
"chrIV","YDL003W (MCD1 PDS3 RHC21 SCC1)","+",446507,446537,446469,68,"F-overlap-F",446469,446537,"chrIV"
"chrIV","YDL004W (ATP16)","+",443752,443807,443622,185,"W-close-W",443622,443807,"chrIV"
"chrIV","YDL005C (MED2)","-",440787,440737,440814,77,"F-overlap-F",440737,440814,"chrIV"
"chrIV","YDL006W (PTC1 CWH47 KCS2 TPD1)","+",440870,440924,440814,110,"F-overlap-F",440814,440924,"chrIV"
"chrIV","YDL007C-A","-",436451,436366,436554,188,"W-close-W",436366,436554,"chrIV"
"chrIV","YDL007W (RPT2 YHS4 YTA5)","+",439439,439609,439335,274,"W-open-W",439335,439609,"chrIV"
"chrIV","YDL008W (APC11)","+",434108,434178,433991,187,"W-close-W",433991,434178,"chrIV"
"chrIV","YDL009C","-",432234,432031,432326,295,"W-open-W",432031,432326,"chrIV"
"chrIV","YDL010W (GRX6)","+",433304,433531,433254,277,"W-open-F",433254,433531,"chrIV"
"chrIV","YDL011C","-",432234,432031,432326,295,"W-open-W",432031,432326,"chrIV"
"chrIV","YDL012C","-",430937,430865,430969,104,"W-overlap-F",430865,430969,"chrIV"
"chrIV","YDL013W (SLX5 HEX3 ULS2)","+",431040,431146,430969,177,"W-close-W",430969,431146,"chrIV"
"chrIV","YDL014W (NOP1 LOT3)","+",428512,428501,428350,151,"W-close-W",428350,428501,"chrIV"
"chrIV","YDL015C (TSC13)","-",425772,425719,425798,79,"F-overlap-F",425719,425798,"chrIV"
"chrIV","YDL017W (CDC7 LSD6 SAS1)","+",425860,425932,425798,134,"F-close-F",425798,425932,"chrIV"
"chrIV","YDL018C (ERP3)","-",422647,422509,422685,176,"W-close-W",422509,422685,"chrIV"
"chrIV","YDL019C (OSH2)","-",417573,417448,417629,181,"W-close-W",417448,417629,"chrIV"
"chrIV","YDL020C (RPN4 SON1 UFD5)","-",414970,414735,415036,301,"F-open-W",414735,415036,"chrIV"
"chrIV","YDL021W (GPM2)","+",414963,415036,414735,301,"W-open-F",414735,415036,"chrIV"
"chrIV","YDL022W (GPD1 DAR1 HOR1 OSG1 OSR5)","+",413156,413284,413005,279,"F-open-F",413005,413284,"chrIV"
"chrIV","YDL024C (DIA3)","-",408119,408013,408188,175,"F-close-W",408013,408188,"chrIV"
"chrIV","YDL025C (RTK1)","-",405231,404948,405415,467,"W-open-W",404948,405415,"chrIV"
"chrIV","YDL025W-A","+",407406,407592,407379,213,"F-close-W",407379,407592,"chrIV"
"chrIV","YDL027C","-",403550,403411,403672,261,"W-open-W",403411,403672,"chrIV"
"chrIV","YDL028C (MPS1 RPK1)","-",400843,400807,400978,171,"F-close-W",400807,400978,"chrIV"
"chrIV","YDL029W (ARP2 ACT2)","+",400793,400807,400639,168,"F-close-W",400639,400807,"chrIV"
"chrIV","YDL030W (PRP9)","+",399220,399369,399080,289,"W-open-W",399080,399369,"chrIV"
"chrIV","YDL031W (DBP10)","+",397285,397515,397228,287,"W-open-W",397228,397515,"chrIV"
"chrIV","YDL033C (SLM3 MTO2 MTU1)","-",392449,392284,392532,248,"W-open-W",392284,392532,"chrIV"
"chrIV","YDL035C (GPR1)","-",389023,388838,389111,273,"W-open-W",388838,389111,"chrIV"
"chrIV","YDL036C (PUS9)","-",387292,387270,387401,131,"F-close-W",387270,387401,"chrIV"
"chrIV","YDL037C (BSC1)","-",384582,384577,384711,134,"F-close-F",384577,384711,"chrIV"
"chrIV","YDL040C (NAT1 AAA1 NAA15)","-",378762,378728,378927,199,"W-close-W",378728,378927,"chrIV"
"chrIV","YDL041W","+",378870,378927,378728,199,"W-close-W",378728,378927,"chrIV"
"chrIV","YDL042C (SIR2 MAR1)","-",376643,376470,376735,265,"W-open-W",376470,376735,"chrIV"
"chrIV","YDL043C (PRP11 RNA11)","-",375389,375259,375513,254,"W-open-W",375259,375513,"chrIV"
"chrIV","YDL044C (MTF2 NAM1)","-",373891,373737,373941,204,"W-close-W",373737,373941,"chrIV"
"chrIV","YDL045C (FAD1)","-",372561,372568,372733,165,"W-close-W",372568,372733,"chrIV"
"chrIV","YDL045W-A (MRP10)","+",372661,372733,372568,165,"W-close-W",372568,372733,"chrIV"
"chrIV","YDL046W (NPC2)","+",372038,372247,371978,269,"W-open-W",371978,372247,"chrIV"
"chrIV","YDL047W (SIT4)","+",370913,370902,370764,138,"W-close-W",370764,370902,"chrIV"
"chrIV","YDL048C (STP4)","-",366653,366604,366692,88,"F-overlap-F",366604,366692,"chrIV"
"chrIV","YDL049C (KNH1)","-",364848,364828,365061,233,"F-open-F",364828,365061,"chrIV"
"chrIV","YDL050C","-",363812,363571,363907,336,"F-open-W",363571,363907,"chrIV"
"chrIV","YDL051W (LHP1 LAH1 YLA1)","+",364891,365061,364828,233,"F-open-F",364828,365061,"chrIV"
"chrIV","YDL052C (SLC1)","-",362595,362389,362683,294,"W-open-F",362389,362683,"chrIV"
"chrIV","YDL053C (PBP4)","-",361520,361317,361549,232,"F-open-W",361317,361549,"chrIV"
"chrIV","YDL054C (MCH1)","-",359746,NA,NA,NA,"+1_missing",359446,359835,"chrIV"
"chrIV","YDL055C (PSA1 MPG1 SRB1 VIG9)","-",355521,355396,355634,238,"F-open-F",355396,355634,"chrIV"
"chrIV","YDL056W (MBP1)","+",355446,355634,355396,238,"F-open-F",355396,355634,"chrIV"
"chrIV","YDL057W","+",352486,352567,352395,172,"W-close-W",352395,352567,"chrIV"
"chrIV","YDL058W (USO1 INT1)","+",351200,351234,351023,211,"W-close-W",351023,351234,"chrIV"
"chrIV","YDL059C (RAD59)","-",344063,343925,344128,203,"F-close-F",343925,344128,"chrIV"
"chrIV","YDL060W (TSR1)","+",344062,344128,343925,203,"F-close-F",343925,344128,"chrIV"
"chrIV","YDL061C (RPS29B YS29B)","-",340461,340469,340706,237,"F-open-F",340469,340706,"chrIV"
"chrIV","YDL063C","-",338168,338136,338299,163,"F-close-F",338136,338299,"chrIV"
"chrIV","YDL064W (UBC9)","+",338192,338299,338136,163,"F-close-F",338136,338299,"chrIV"
"chrIV","YDL065C (PEX19 PAS12)","-",336167,336122,336321,199,"F-close-F",336122,336321,"chrIV"
"chrIV","YDL066W (IDP1)","+",336294,336321,336122,199,"F-close-F",336122,336321,"chrIV"
"chrIV","YDL067C (COX9)","-",333975,333873,334039,166,"F-close-F",333873,334039,"chrIV"
"chrIV","YDL068W","+",334069,334199,334039,160,"F-close-F",334039,334199,"chrIV"
"chrIV","YDL069C (CBS1)","-",333007,332940,333083,143,"F-close-F",332940,333083,"chrIV"
"chrIV","YDL070W (BDF2)","+",333097,333083,332940,143,"F-close-F",332940,333083,"chrIV"
"chrIV","YDL072C (YET3)","-",329748,329567,329857,290,"W-open-F",329567,329857,"chrIV"
"chrIV","YDL073W","+",329623,329857,329567,290,"F-open-W",329567,329857,"chrIV"
"chrIV","YDL074C (BRE1)","-",323938,323920,324107,187,"W-close-W",323920,324107,"chrIV"
"chrIV","YDL075W (RPL31A RPL34)","+",323060,323115,322896,219,"F-open-F",322896,323115,"chrIV"
"chrIV","YDL076C (RXT3)","-",320474,320451,320619,168,"W-close-W",320451,320619,"chrIV"
"chrIV","YDL077C (VAM6 CVT4 VPL18 VPL22 VPS39)","-",316906,316819,317008,189,"W-close-W",316819,317008,"chrIV"
"chrIV","YDL078C (MDH3)","-",315260,315201,315388,187,"W-close-W",315201,315388,"chrIV"
"chrIV","YDL079C (MRK1)","-",312833,312830,312919,89,"W-overlap-F",312830,312919,"chrIV"
"chrIV","YDL080C (THI3 KID1)","-",310475,310449,310633,184,"W-close-W",310449,310633,"chrIV"
"chrIV","YDL081C (RPP1A RPLA1)","-",309694,309631,309848,217,"F-open-W",309631,309848,"chrIV"
"chrIV","YDL082W (RPL13A)","+",309524,309524,309429,95,"F-overlap-F",309429,309524,"chrIV"
"chrIV","YDL083C (RPS16B)","-",306796,306756,306850,94,"F-overlap-F",306756,306850,"chrIV"
"chrIV","YDL084W (SUB2)","+",306664,306649,306507,142,"F-close-F",306507,306649,"chrIV"
"chrIV","YDL085C-A","-",302285,302194,302432,238,"F-open-F",302194,302432,"chrIV"
"chrIV","YDL085W (NDE2 NDH2)","+",304935,305117,304799,318,"W-open-W",304799,305117,"chrIV"
"chrIV","YDL086C-A","-",301393,301214,301434,220,"W-open-W",301214,301434,"chrIV"
"chrIV","YDL086W","+",302301,302432,302194,238,"F-open-F",302194,302432,"chrIV"
"chrIV","YDL087C (LUC7 EPE1 EXM2)","-",300054,299911,300081,170,"W-close-W",299911,300081,"chrIV"
"chrIV","YDL088C (ASM4 NUP59)","-",298263,298117,298290,173,"F-close-W",298117,298290,"chrIV"
"chrIV","YDL089W (NUR1)","+",298346,298501,298290,211,"F-close-F",298290,298501,"chrIV"
"chrIV","YDL090C (RAM1 DPR1 FUS8 SCG2 SGP2 STE16)","-",294903,294799,295001,202,"W-close-W",294799,295001,"chrIV"
"chrIV","YDL091C (UBX3)","-",293290,293272,293491,219,"W-open-F",293272,293491,"chrIV"
"chrIV","YDL092W (SRP14)","+",293367,293491,293272,219,"F-open-W",293272,293491,"chrIV"
"chrIV","YDL093W (PMT5)","+",292420,292527,292354,173,"W-close-W",292354,292527,"chrIV"
"chrIV","YDL094C","-",289556,289448,289618,170,"W-close-W",289448,289618,"chrIV"
"chrIV","YDL095W (PMT1)","+",289622,289618,289448,170,"W-close-W",289448,289618,"chrIV"
"chrIV","YDL097C (RPN6 NAS4)","-",285300,285148,285388,240,"W-open-W",285148,285388,"chrIV"
"chrIV","YDL098C (SNU23)","-",284443,284384,284642,258,"F-open-F",284384,284642,"chrIV"
"chrIV","YDL099W (BUG1)","+",284522,284642,284384,258,"F-open-F",284384,284642,"chrIV"
"chrIV","YDL100C (GET3 ARR4)","-",282031,281870,282145,275,"W-open-W",281870,282145,"chrIV"
"chrIV","YDL101C (DUN1)","-",280179,280169,280368,199,"F-close-W",280169,280368,"chrIV"
"chrIV","YDL102W (POL3 CDC2 HPR6 TEX1)","+",280288,280368,280169,199,"W-close-F",280169,280368,"chrIV"
"chrIV","YDL103C (QRI1 UAP1)","-",275027,274847,275071,224,"W-open-W",274847,275071,"chrIV"
"chrIV","YDL104C (QRI7)","-",273564,273549,273719,170,"W-close-W",273549,273719,"chrIV"
"chrIV","YDL105W (NSE4 QRI2)","+",274104,274193,274067,126,"F-close-W",274067,274193,"chrIV"
"chrIV","YDL106C (PHO2 BAS2 GRF10 phoB)","-",269975,269967,270103,136,"F-close-F",269967,270103,"chrIV"
"chrIV","YDL107W (MSS2)","+",270128,270293,270103,190,"F-close-W",270103,270293,"chrIV"
"chrIV","YDL108W (KIN28)","+",268752,268733,268574,159,"W-close-W",268574,268733,"chrIV"
"chrIV","YDL109C","-",264975,264973,NA,NA,"-1_missing",264973,265281,"chrIV"
"chrIV","YDL110C (TMA17)","-",264325,264118,264487,369,"W-open-W",264118,264487,"chrIV"
"chrIV","YDL111C (RRP42)","-",263250,263221,263298,77,"F-overlap-F",263221,263298,"chrIV"
"chrIV","YDL112W (TRM3)","+",263336,263448,263298,150,"F-close-W",263298,263448,"chrIV"
"chrIV","YDL113C (ATG20 CVT20 SNX42)","-",256518,256465,256639,174,"F-close-F",256465,256639,"chrIV"
"chrIV","YDL114W","+",256638,256639,256465,174,"F-close-F",256465,256639,"chrIV"
"chrIV","YDL114W-A","+",255163,255373,255115,258,"W-open-W",255115,255373,"chrIV"
"chrIV","YDL115C (IWR1)","-",253900,253753,253938,185,"F-close-W",253753,253938,"chrIV"
"chrIV","YDL116W (NUP84)","+",253822,253938,253753,185,"W-close-F",253753,253938,"chrIV"
"chrIV","YDL117W (CYK3)","+",251372,251553,251265,288,"W-open-W",251265,251553,"chrIV"
"chrIV","YDL119C","-",246533,246535,246699,164,"F-close-F",246535,246699,"chrIV"
"chrIV","YDL120W (YFH1)","+",246601,246699,246535,164,"F-close-F",246535,246699,"chrIV"
"chrIV","YDL121C","-",244958,244889,245048,159,"F-close-W",244889,245048,"chrIV"
"chrIV","YDL122W (UBP1)","+",245056,245048,244889,159,"W-close-F",244889,245048,"chrIV"
"chrIV","YDL123W (SNA4)","+",242238,242364,242039,325,"W-open-F",242039,242364,"chrIV"
"chrIV","YDL124W","+",241269,241437,241150,287,"W-open-W",241150,241437,"chrIV"
"chrIV","YDL125C (HNT1)","-",238895,238663,238950,287,"W-open-W",238663,238950,"chrIV"
"chrIV","YDL126C (CDC48)","-",236081,235911,236159,248,"F-open-W",235911,236159,"chrIV"
"chrIV","YDL127W (PCL2 CLN4)","+",236020,236159,235911,248,"W-open-F",235911,236159,"chrIV"
"chrIV","YDL128W (VCX1 HUM1 MNR1)","+",234060,234121,233928,193,"W-close-W",233928,234121,"chrIV"
"chrIV","YDL129W","+",232339,232613,232319,294,"F-open-W",232319,232613,"chrIV"
"chrIV","YDL130W (RPP1B RPL44' RPLA3)","+",230629,230683,230480,203,"F-close-W",230480,230683,"chrIV"
"chrIV","YDL130W-A (STF1 AIS2)","+",229593,229860,229479,381,"W-open-W",229479,229860,"chrIV"
"chrIV","YDL131W (LYS21)","+",228817,228842,228652,190,"W-close-W",228652,228842,"chrIV"
"chrIV","YDL132W (CDC53)","+",226898,226964,226715,249,"F-open-F",226715,226964,"chrIV"
"chrIV","YDL133C-A (RPL41B RPL47B YDL134C-A)","-",221511,221502,221697,195,"W-close-F",221502,221697,"chrIV"
"chrIV","YDL133W","+",223839,224071,223782,289,"W-open-W",223782,224071,"chrIV"
"chrIV","YDL134C (PPH21 PPH1)","-",219580,219430,219632,202,"F-close-F",219430,219632,"chrIV"
"chrIV","YDL135C (RDI1)","-",218427,218312,218454,142,"F-close-F",218312,218454,"chrIV"
"chrIV","YDL136W (RPL35B SOS2)","+",218459,218454,218312,142,"F-close-F",218312,218454,"chrIV"
"chrIV","YDL137W (ARF2)","+",217218,NA,NA,NA,"+1_missing",217162,217605,"chrIV"
"chrIV","YDL138W (RGT2)","+",215786,216057,215727,330,"F-open-W",215727,216057,"chrIV"
"chrIV","YDL139C (SCM3)","-",211254,211079,211419,340,"W-open-W",211079,211419,"chrIV"
"chrIV","YDL140C (RPO21 RPB1 RPB220 SUA8)","-",205260,205129,205502,373,"F-open-F",205129,205502,"chrIV"
"chrIV","YDL141W (BPL1 ACC2)","+",205374,205502,205129,373,"F-open-F",205129,205502,"chrIV"
"chrIV","YDL142C (CRD1 CLS1)","-",201592,201476,201819,343,"F-open-F",201476,201819,"chrIV"
"chrIV","YDL143W (CCT4 ANC2 TCP4)","+",201680,201819,201476,343,"F-open-F",201476,201819,"chrIV"
"chrIV","YDL144C","-",198570,198414,198684,270,"W-open-W",198414,198684,"chrIV"
"chrIV","YDL145C (COP1 RET1 SEC33 SOO1)","-",194395,194396,194632,236,"F-open-F",194396,194632,"chrIV"
"chrIV","YDL146W (LDB17)","+",194349,194396,194318,78,"F-overlap-F",194318,194396,"chrIV"
"chrIV","YDL147W (RPN5 NAS5)","+",192407,192612,192348,264,"W-open-F",192348,192612,"chrIV"
"chrIV","YDL148C (NOP14 UTP2)","-",187873,187737,187926,189,"F-close-F",187737,187926,"chrIV"
"chrIV","YDL149W (ATG9 APG9 AUT9 CVT7)","+",188015,188051,187926,125,"F-close-F",187926,188051,"chrIV"
"chrIV","YDL150W (RPC53 RPC4)","+",184706,184940,184674,266,"W-open-W",184674,184940,"chrIV"
"chrIV","YDL153C (SAS10 UTP3)","-",181069,181042,181117,75,"F-overlap-F",181042,181117,"chrIV"
"chrIV","YDL155W (CLB3)","+",178190,178308,178131,177,"F-close-F",178131,178308,"chrIV"
"chrIV","YDL157C","-",174199,174033,174246,213,"W-close-F",174033,174246,"chrIV"
"chrIV","YDL159C-B (YDL159C-A)","-",172434,172159,172483,324,"W-open-W",172159,172483,"chrIV"
"chrIV","YDL159W (STE7)","+",174168,174246,174033,213,"F-close-W",174033,174246,"chrIV"
"chrIV","YDL160C (DHH1)","-",170111,170029,170182,153,"F-close-F",170029,170182,"chrIV"
"chrIV","YDL160C-A","-",169147,169061,169232,171,"W-close-W",169061,169232,"chrIV"
"chrIV","YDL161W (ENT1)","+",169199,169232,169061,171,"W-close-W",169061,169232,"chrIV"
"chrIV","YDL164C (CDC9 MMS8)","-",164825,164775,164968,193,"W-close-W",164775,164968,"chrIV"
"chrIV","YDL165W (CDC36 DNA19 NOT2)","+",164910,164968,164775,193,"W-close-W",164775,164968,"chrIV"
"chrIV","YDL166C (FAP7)","-",163363,163163,163424,261,"W-open-W",163163,163424,"chrIV"
"chrIV","YDL167C (NRP1)","-",160840,160853,160922,69,"F-overlap-F",160853,160922,"chrIV"
"chrIV","YDL168W (SFA1 ADH5)","+",160861,160853,160769,84,"F-overlap-F",160769,160853,"chrIV"
"chrIV","YDL169C (UGX2)","-",157991,157878,158100,222,"F-open-W",157878,158100,"chrIV"
"chrIV","YDL170W (UGA3)","+",158051,158100,157878,222,"W-open-F",157878,158100,"chrIV"
"chrIV","YDL171C (GLT1)","-",149063,148920,NA,NA,"-1_missing",148920,149372,"chrIV"
"chrIV","YDL173W (PAR32)","+",149184,149372,148920,452,"F-open-W",148920,149372,"chrIV"
"chrIV","YDL174C (DLD1)","-",145734,145511,145778,267,"W-open-W",145511,145778,"chrIV"
"chrIV","YDL175C (AIR2)","-",144266,144180,144295,115,"F-overlap-F",144180,144295,"chrIV"
"chrIV","YDL176W","+",144338,144504,144295,209,"F-close-F",144295,144504,"chrIV"
"chrIV","YDL177C","-",141119,141045,141254,209,"W-close-W",141045,141254,"chrIV"
"chrIV","YDL178W (DLD2 AIP2)","+",141190,141254,141045,209,"W-close-W",141045,141254,"chrIV"
"chrIV","YDL179W (PCL9)","+",139357,139531,139320,211,"F-close-W",139320,139531,"chrIV"
"chrIV","YDL180W","+",137602,137669,137488,181,"W-close-F",137488,137669,"chrIV"
"chrIV","YDL181W (INH1)","+",135552,135770,135503,267,"F-open-W",135503,135770,"chrIV"
"chrIV","YDL182W (LYS20)","+",134811,135021,134677,344,"W-open-W",134677,135021,"chrIV"
"chrIV","YDL183C","-",130800,NA,NA,NA,"+1_missing",130476,130922,"chrIV"
"chrIV","YDL184C (RPL41A RPL47A)","-",130192,130160,130320,160,"W-close-W",130160,130320,"chrIV"
"chrIV","YDL185W (VMA1 CLS8 TFP1)","+",130123,130160,129963,197,"F-close-W",129963,130160,"chrIV"
"chrIV","YDL186W","+",126694,126724,126408,316,"W-open-W",126408,126724,"chrIV"
"chrIV","YDL187C","-",125358,125371,125635,264,"W-open-W",125371,125635,"chrIV"
"chrIV","YDL188C (PPH22 PPH2)","-",123738,123655,123886,231,"W-open-F",123655,123886,"chrIV"
"chrIV","YDL189W (RBS1)","+",123695,123886,123655,231,"F-open-W",123655,123886,"chrIV"
"chrIV","YDL190C (UFD2)","-",118499,118472,118541,69,"F-overlap-F",118472,118541,"chrIV"
"chrIV","YDL191W (RPL35A SOS1)","+",118616,118670,118541,129,"F-close-F",118541,118670,"chrIV"
"chrIV","YDL192W (ARF1)","+",117020,117084,116924,160,"W-close-F",116924,117084,"chrIV"
"chrIV","YDL193W (NUS1)","+",115995,116285,115950,335,"W-open-W",115950,116285,"chrIV"
"chrIV","YDL194W (SNF3)","+",114395,114608,114335,273,"W-open-F",114335,114608,"chrIV"
"chrIV","YDL195W (SEC31 WEB1)","+",111162,111413,111119,294,"F-open-W",111119,111413,"chrIV"
"chrIV","YDL197C (ASF2)","-",104823,104657,104928,271,"W-open-W",104657,104928,"chrIV"
"chrIV","YDL198C (GGC1 YHM1)","-",103527,103356,103666,310,"W-open-W",103356,103666,"chrIV"
"chrIV","YDL199C","-",101206,101224,101394,170,"F-close-W",101224,101394,"chrIV"
"chrIV","YDL200C (MGT1 MGMT)","-",100429,100349,100531,182,"F-close-W",100349,100531,"chrIV"
"chrIV","YDL201W (TRM8)","+",100504,100531,100349,182,"W-close-F",100349,100531,"chrIV"
"chrIV","YDL202W (MRPL11)","+",99353,99539,99292,247,"W-open-W",99292,99539,"chrIV"
"chrIV","YDL203C (ACK1)","-",95886,95784,95957,173,"F-close-F",95784,95957,"chrIV"
"chrIV","YDL204W (RTN2)","+",95965,95957,95784,173,"F-close-F",95784,95957,"chrIV"
"chrIV","YDL205C (HEM3 OLE2)","-",92557,92354,92600,246,"F-open-F",92354,92600,"chrIV"
"chrIV","YDL206W","+",92502,92600,92354,246,"F-open-F",92354,92600,"chrIV"
"chrIV","YDL207W (GLE1 BRR3 RSS1)","+",89944,90077,89811,266,"W-open-W",89811,90077,"chrIV"
"chrIV","YDL208W (NHP2)","+",88109,88273,87995,278,"F-open-W",87995,88273,"chrIV"
"chrIV","YDL209C (CWC2 NTC40)","-",86011,85957,86221,264,"W-open-W",85957,86221,"chrIV"
"chrIV","YDL211C","-",79139,79081,79262,181,"W-close-F",79081,79262,"chrIV"
"chrIV","YDL212W (SHR3 APF1)","+",79214,79262,79081,181,"F-close-W",79081,79262,"chrIV"
"chrIV","YDL213C (NOP6)","-",77216,NA,NA,NA,"+1_missing",76801,77366,"chrIV"
"chrIV","YDL214C (PRR2)","-",74335,74092,74424,332,"W-open-W",74092,74424,"chrIV"
"chrIV","YDL215C (GDH2 GDH-B GDHB)","-",70486,70269,70705,436,"W-open-W",70269,70705,"chrIV"
"chrIV","YDL216C (RRI1 CSN5 JAB1)","-",68871,68733,68999,266,"W-open-W",68733,68999,"chrIV"
"chrIV","YDL217C (TIM22)","-",67857,67856,67925,69,"F-overlap-F",67856,67925,"chrIV"
"chrIV","YDL218W","+",67675,67739,67530,209,"F-close-F",67530,67739,"chrIV"
"chrIV","YDL219W (DTD1)","+",65845,65906,65738,168,"W-close-W",65738,65906,"chrIV"
"chrIV","YDL220C (CDC13 EST4)","-",61888,61800,62050,250,"W-open-F",61800,62050,"chrIV"
"chrIV","YDL221W","+",63187,63246,63055,191,"W-close-W",63055,63246,"chrIV"
"chrIV","YDL222C (FMP45)","-",60477,60403,60559,156,"F-close-F",60403,60559,"chrIV"
"chrIV","YDL224C (WHI4)","-",54251,54256,54490,234,"F-open-F",54256,54490,"chrIV"
"chrIV","YDL225W (SHS1 SEP7)","+",54203,54256,54082,174,"F-close-F",54082,54256,"chrIV"
"chrIV","YDL226C (GCS1)","-",50891,50874,51022,148,"F-close-F",50874,51022,"chrIV"
"chrIV","YDL227C (HO)","-",46208,46163,46349,186,"W-close-F",46163,46349,"chrIV"
"chrIV","YDL228C","-",45059,NA,NA,NA,"+1_missing",44546,45286,"chrIV"
"chrIV","YDL229W (SSB1 YG101)","+",46008,46092,45846,246,"W-open-F",45846,46092,"chrIV"
"chrIV","YDL230W (PTP1)","+",43749,NA,NA,NA,"+1_missing",43681,44053,"chrIV"
"chrIV","YDL231C (BRE4)","-",38807,38684,38841,157,"F-close-W",38684,38841,"chrIV"
"chrIV","YDL232W (OST4)","+",38855,38841,38684,157,"W-close-F",38684,38841,"chrIV"
"chrIV","YDL233W","+",38340,38515,38237,278,"W-open-W",38237,38515,"chrIV"
"chrIV","YDL234C (GYP7)","-",34179,33994,34293,299,"W-open-W",33994,34293,"chrIV"
"chrIV","YDL235C (YPD1)","-",33272,33148,33332,184,"F-close-F",33148,33332,"chrIV"
"chrIV","YDL236W (PHO13)","+",33374,33499,33332,167,"F-close-W",33332,33499,"chrIV"
"chrIV","YDL237W (AIM6 LRC1)","+",31998,32008,31860,148,"W-close-W",31860,32008,"chrIV"
"chrIV","YDL238C (GUD1)","-",28906,28850,29012,162,"W-close-W",28850,29012,"chrIV"
"chrIV","YDL239C (ADY3)","-",26344,26277,26486,209,"W-close-W",26277,26486,"chrIV"
"chrIV","YDL240W (LRG1)","+",26121,26120,26024,96,"F-overlap-F",26024,26120,"chrIV"
"chrIV","YDL241W","+",21264,21328,21151,177,"W-close-W",21151,21328,"chrIV"
"chrIV","YDL243C (AAD4)","-",17470,17427,17610,183,"W-close-W",17427,17610,"chrIV"
"chrIV","YDL248W (COS7)","+",3569,NA,NA,NA,"+1_missing",3569,16606,"chrIV"
"chrIV","YDR001C (NTH1)","-",450109,450120,450201,81,"W-overlap-F",450120,450201,"chrIV"
"chrIV","YDR002W (YRB1 CST20 HTN1 SFO1)","+",453830,453819,453622,197,"F-close-W",453622,453819,"chrIV"
"chrIV","YDR003W (RCR2 SSH5)","+",455034,455295,454982,313,"W-open-F",454982,455295,"chrIV"
"chrIV","YDR003W-A","+",455073,455295,454982,313,"W-open-F",454982,455295,"chrIV"
"chrIV","YDR004W (RAD57)","+",456751,456851,456700,151,"F-close-W",456700,456851,"chrIV"
"chrIV","YDR005C (MAF1)","-",456669,456548,456700,152,"F-close-F",456548,456700,"chrIV"
"chrIV","YDR006C (SOK1)","-",458444,458455,458641,186,"W-close-W",458455,458641,"chrIV"
"chrIV","YDR007W (TRP1)","+",462619,462698,462370,328,"F-open-W",462370,462698,"chrIV"
"chrIV","YDR009W (GAL3)","+",465110,NA,NA,NA,"+1_missing",465057,465549,"chrIV"
"chrIV","YDR010C","-",465013,464836,465057,221,"F-open-F",464836,465057,"chrIV"
"chrIV","YDR011W (SNQ2)","+",470599,470639,470437,202,"F-close-W",470437,470639,"chrIV"
"chrIV","YDR012W (RPL4B)","+",473018,473188,472946,242,"W-open-W",472946,473188,"chrIV"
"chrIV","YDR013W (PSF1 CDC101)","+",473872,473862,473679,183,"W-close-W",473679,473862,"chrIV"
"chrIV","YDR014W (RAD61 WPL1)","+",476341,476474,476297,177,"F-close-F",476297,476474,"chrIV"
"chrIV","YDR014W-A (HED1)","+",478443,478452,478369,83,"F-overlap-W",478369,478452,"chrIV"
"chrIV","YDR016C (DAD1)","-",478352,478369,478452,83,"W-overlap-F",478369,478452,"chrIV"
"chrIV","YDR017C (KCS1)","-",478942,478743,479015,272,"W-open-W",478743,479015,"chrIV"
"chrIV","YDR018C","-",482537,482349,482649,300,"F-open-F",482349,482649,"chrIV"
"chrIV","YDR019C (GCV1 GSD1)","-",483984,483835,484120,285,"F-open-W",483835,484120,"chrIV"
"chrIV","YDR020C (DAS2 RRT3)","-",485414,485398,485599,201,"W-close-W",485398,485599,"chrIV"
"chrIV","YDR021W (FAL1)","+",488057,488148,488035,113,"F-overlap-F",488035,488148,"chrIV"
"chrIV","YDR022C (CIS1 ATG31)","-",487971,487897,488035,138,"F-close-F",487897,488035,"chrIV"
"chrIV","YDR023W (SES1)","+",490942,490991,490800,191,"W-close-W",490800,490991,"chrIV"
"chrIV","YDR025W (RPS11A)","+",492421,492469,492265,204,"F-close-W",492265,492469,"chrIV"
"chrIV","YDR026C","-",492467,492469,492540,71,"F-overlap-W",492469,492540,"chrIV"
"chrIV","YDR027C (VPS54 CGP1 LUV1 TCS3)","-",494567,494392,494658,266,"W-open-W",494392,494658,"chrIV"
"chrIV","YDR028C (REG1 HEX2 PZF240 SPP43 SRN1)","-",497557,497400,497678,278,"W-open-W",497400,497678,"chrIV"
"chrIV","YDR030C (RAD28)","-",501654,501564,501824,260,"W-open-W",501564,501824,"chrIV"
"chrIV","YDR031W (MIC14)","+",504016,504042,503846,196,"W-close-F",503846,504042,"chrIV"
"chrIV","YDR032C (PST2)","-",503936,503846,504042,196,"F-close-W",503846,504042,"chrIV"
"chrIV","YDR033W (MRH1)","+",509557,509653,509474,179,"F-close-F",509474,509653,"chrIV"
"chrIV","YDR034C (LYS14)","-",509600,509474,509653,179,"F-close-F",509474,509653,"chrIV"
"chrIV","YDR034C-A","-",520488,520437,520522,85,"W-overlap-F",520437,520522,"chrIV"
"chrIV","YDR034W-B","+",521698,521726,521653,73,"F-overlap-W",521653,521726,"chrIV"
"chrIV","YDR035W (ARO3)","+",523141,523208,522971,237,"F-open-F",522971,523208,"chrIV"
"chrIV","YDR036C (EHD3 MRP5)","-",523072,522971,523208,237,"F-open-F",522971,523208,"chrIV"
"chrIV","YDR037W (KRS1 GCD5)","+",527288,527357,527227,130,"W-close-F",527227,527357,"chrIV"
"chrIV","YDR041W (RSM10)","+",540586,540668,540486,182,"F-close-W",540486,540668,"chrIV"
"chrIV","YDR042C","-",540498,540486,540668,182,"W-close-F",540486,540668,"chrIV"
"chrIV","YDR043C (NRG1)","-",542570,542331,542703,372,"W-open-F",542331,542703,"chrIV"
"chrIV","YDR044W (HEM13)","+",547765,547761,547607,154,"F-close-W",547607,547761,"chrIV"
"chrIV","YDR045C (RPC11)","-",547758,547761,547929,168,"F-close-W",547761,547929,"chrIV"
"chrIV","YDR046C (BAP3 PAP1)","-",548680,548447,548714,267,"W-open-W",548447,548714,"chrIV"
"chrIV","YDR047W (HEM12 HEM6)","+",553024,553244,552975,269,"W-open-W",552975,553244,"chrIV"
"chrIV","YDR048C","-",550667,550669,550843,174,"F-close-F",550669,550843,"chrIV"
"chrIV","YDR049W (VMS1)","+",555269,555490,555239,251,"F-open-W",555239,555490,"chrIV"
"chrIV","YDR050C (TPI1)","-",555649,555490,555844,354,"F-open-W",555490,555844,"chrIV"
"chrIV","YDR051C (DET1)","-",556996,NA,NA,NA,"+1_missing",556672,557020,"chrIV"
"chrIV","YDR052C (DBF4 DNA52 LSD7)","-",558270,558057,558315,258,"F-open-W",558057,558315,"chrIV"
"chrIV","YDR054C (CDC34 DNA6 UBC3)","-",560973,560719,561034,315,"W-open-W",560719,561034,"chrIV"
"chrIV","YDR055W (PST1 HPF2)","+",564994,565024,564808,216,"W-open-F",564808,565024,"chrIV"
"chrIV","YDR056C","-",564919,564808,565024,216,"F-open-W",564808,565024,"chrIV"
"chrIV","YDR057W (YOS9)","+",567641,567705,567509,196,"W-close-W",567509,567705,"chrIV"
"chrIV","YDR058C (TGL2)","-",567591,567509,567705,196,"W-close-W",567509,567705,"chrIV"
"chrIV","YDR059C (UBC5)","-",569110,568883,569154,271,"W-open-F",568883,569154,"chrIV"
"chrIV","YDR060W (MAK21 NOC1)","+",573814,573855,573734,121,"F-close-F",573734,573855,"chrIV"
"chrIV","YDR061W","+",575893,576123,575826,297,"W-open-W",575826,576123,"chrIV"
"chrIV","YDR062W (LCB2 SCS1 TSC1)","+",578436,578597,578326,271,"F-open-W",578326,578597,"chrIV"
"chrIV","YDR063W (AIM7 GMF GMF1)","+",579187,579462,579072,390,"W-open-W",579072,579462,"chrIV"
"chrIV","YDR064W (RPS13 RPS13B RPS13C)","+",580535,580679,580381,298,"F-open-F",580381,580679,"chrIV"
"chrIV","YDR065W (RRG1)","+",582368,582411,582231,180,"F-close-W",582231,582411,"chrIV"
"chrIV","YDR066C (RTR2)","-",581804,581703,581898,195,"W-close-F",581703,581898,"chrIV"
"chrIV","YDR067C (OCA6)","-",582706,582711,582781,70,"F-overlap-F",582711,582781,"chrIV"
"chrIV","YDR068W (DOS2)","+",584737,584770,584584,186,"W-close-W",584584,584770,"chrIV"
"chrIV","YDR069C (DOA4 DOS1 MUT4 NPI2 SSV7 UBP4)","-",584634,584584,584770,186,"W-close-W",584584,584770,"chrIV"
"chrIV","YDR070C (FMP16)","-",587945,587723,588007,284,"F-open-W",587723,588007,"chrIV"
"chrIV","YDR071C (PAA1)","-",588736,588751,588916,165,"F-close-F",588751,588916,"chrIV"
"chrIV","YDR072C (IPT1 KTI6 SYR4)","-",589667,589445,589781,336,"W-open-W",589445,589781,"chrIV"
"chrIV","YDR073W (SNF11)","+",593202,593295,593156,139,"F-close-F",593156,593295,"chrIV"
"chrIV","YDR074W (TPS2 HOG2 PFK3)","+",596821,597027,596767,260,"F-open-W",596767,597027,"chrIV"
"chrIV","YDR075W (PPH3)","+",598232,598463,598182,281,"W-open-W",598182,598463,"chrIV"
"chrIV","YDR076W (RAD55)","+",600765,600828,600713,115,"F-overlap-F",600713,600828,"chrIV"
"chrIV","YDR077W (SED1)","+",602134,602156,601974,182,"W-close-F",601974,602156,"chrIV"
"chrIV","YDR078C (SHU2)","-",602059,601974,602156,182,"F-close-W",601974,602156,"chrIV"
"chrIV","YDR079C-A (TFB5)","-",603398,603264,603441,177,"W-close-W",603264,603441,"chrIV"
"chrIV","YDR079W (PET100)","+",603587,603634,603441,193,"W-close-W",603441,603634,"chrIV"
"chrIV","YDR080W (VPS41 CVT8 FET2 SVL2 VAM2 VPL20)","+",607042,607160,606951,209,"F-close-W",606951,607160,"chrIV"
"chrIV","YDR081C (PDC2)","-",607269,607160,607363,203,"F-close-W",607160,607363,"chrIV"
"chrIV","YDR082W (STN1)","+",612063,612112,611818,294,"W-open-F",611818,612112,"chrIV"
"chrIV","YDR083W (RRP8)","+",613341,613377,613150,227,"F-open-F",613150,613377,"chrIV"
"chrIV","YDR084C (TVP23)","-",613178,613150,613377,227,"F-open-F",613150,613377,"chrIV"
"chrIV","YDR085C (AFR1)","-",614204,614222,614427,205,"W-close-F",614222,614427,"chrIV"
"chrIV","YDR086C (SSS1)","-",616738,616661,616784,123,"F-close-F",616661,616784,"chrIV"
"chrIV","YDR087C (RRP1)","-",617377,617183,617500,317,"W-open-W",617183,617500,"chrIV"
"chrIV","YDR088C (SLU7 SLT17)","-",618310,618299,618573,274,"W-open-W",618299,618573,"chrIV"
"chrIV","YDR089W","+",624813,624796,624635,161,"W-close-F",624635,624796,"chrIV"
"chrIV","YDR090C","-",624729,624635,624796,161,"F-close-W",624635,624796,"chrIV"
"chrIV","YDR091C (RLI1)","-",626366,626346,626533,187,"W-close-W",626346,626533,"chrIV"
"chrIV","YDR092W (UBC13)","+",630699,630708,630520,188,"W-close-W",630520,630708,"chrIV"
"chrIV","YDR093W (DNF2)","+",636247,636262,636065,197,"W-close-F",636065,636262,"chrIV"
"chrIV","YDR096W (GIS1)","+",640037,640121,639918,203,"W-close-F",639918,640121,"chrIV"
"chrIV","YDR097C (MSH6 PMS3)","-",640048,639918,640121,203,"F-close-W",639918,640121,"chrIV"
"chrIV","YDR099W (BMH2 SCD3)","+",654655,654740,654543,197,"F-close-W",654543,654740,"chrIV"
"chrIV","YDR100W (TVP15)","+",655615,655744,655530,214,"W-close-F",655530,655744,"chrIV"
"chrIV","YDR101C (ARX1)","-",655567,655530,655744,214,"F-close-W",655530,655744,"chrIV"
"chrIV","YDR103W (STE5 HMD3 NUL3)","+",661149,661190,661048,142,"F-close-F",661048,661190,"chrIV"
"chrIV","YDR104C (SPO71)","-",661024,660892,661048,156,"F-close-F",660892,661048,"chrIV"
"chrIV","YDR105C (TMS1)","-",665263,665167,665341,174,"W-close-W",665167,665341,"chrIV"
"chrIV","YDR106W (ARP10)","+",667905,NA,NA,NA,"+1_missing",667872,668406,"chrIV"
"chrIV","YDR107C (TMN2)","-",668841,668790,669131,341,"F-open-F",668790,669131,"chrIV"
"chrIV","YDR108W (TRS85 GSG1 MUM1)","+",673464,673562,673422,140,"F-close-F",673422,673562,"chrIV"
"chrIV","YDR109C","-",673372,673319,673422,103,"F-overlap-F",673319,673422,"chrIV"
"chrIV","YDR110W (FOB1 HRM1)","+",677985,678143,677939,204,"F-close-F",677939,678143,"chrIV"
"chrIV","YDR111C (ALT2)","-",678064,677939,678143,204,"F-close-F",677939,678143,"chrIV"
"chrIV","YDR113C (PDS1)","-",680422,680278,680551,273,"W-open-W",680278,680551,"chrIV"
"chrIV","YDR115W","+",682620,682723,682522,201,"W-close-W",682522,682723,"chrIV"
"chrIV","YDR116C (MRPL1)","-",682605,682522,682723,201,"W-close-W",682522,682723,"chrIV"
"chrIV","YDR117C (TMA64 RBF64)","-",683901,683832,684011,179,"W-close-W",683832,684011,"chrIV"
"chrIV","YDR119W (VBA4)","+",690609,690790,690475,315,"W-open-W",690475,690790,"chrIV"
"chrIV","YDR119W-A","+",691464,691528,691312,216,"W-open-W",691312,691528,"chrIV"
"chrIV","YDR120C (TRM1)","-",691339,691312,691528,216,"W-open-W",691312,691528,"chrIV"
"chrIV","YDR121W (DPB4)","+",694283,694447,694169,278,"W-open-W",694169,694447,"chrIV"
"chrIV","YDR122W (KIN1)","+",698045,698067,697875,192,"F-close-W",697875,698067,"chrIV"
"chrIV","YDR123C (INO2 DIE1 SCS1)","-",697909,697875,698067,192,"W-close-F",697875,698067,"chrIV"
"chrIV","YDR124W","+",701816,701816,701687,129,"W-close-W",701687,701816,"chrIV"
"chrIV","YDR125C (ECM18)","-",700240,700172,700346,174,"W-close-W",700172,700346,"chrIV"
"chrIV","YDR126W (SWF1 PSL10)","+",704528,704614,704439,175,"W-close-W",704439,704614,"chrIV"
"chrIV","YDR127W (ARO1)","+",709320,709517,709272,245,"W-open-F",709272,709517,"chrIV"
"chrIV","YDR128W (MTC5)","+",713128,713134,712935,199,"W-close-F",712935,713134,"chrIV"
"chrIV","YDR129C (SAC6 ABP67)","-",713194,713134,713330,196,"F-close-F",713134,713330,"chrIV"
"chrIV","YDR130C (FIN1)","-",715477,715373,715657,284,"F-open-W",715373,715657,"chrIV"
"chrIV","YDR131C","-",716711,716620,716871,251,"W-open-W",716620,716871,"chrIV"
"chrIV","YDR132C","-",718699,718524,718731,207,"W-close-W",718524,718731,"chrIV"
"chrIV","YDR133C","-",720788,720658,720817,159,"F-close-W",720658,720817,"chrIV"
"chrIV","YDR135C (YCF1)","-",722910,NA,NA,NA,"+1_missing",722462,723005,"chrIV"
"chrIV","YDR137W (RGP1)","+",730402,730447,730314,133,"W-close-F",730314,730447,"chrIV"
"chrIV","YDR138W (HPR1 TRF1)","+",733448,733578,733391,187,"W-close-W",733391,733578,"chrIV"
"chrIV","YDR139C (RUB1)","-",733444,733391,733578,187,"W-close-W",733391,733578,"chrIV"
"chrIV","YDR140W (MTQ2)","+",734907,735025,734839,186,"F-close-W",734839,735025,"chrIV"
"chrIV","YDR141C (DOP1)","-",734730,734726,734839,113,"F-overlap-F",734726,734839,"chrIV"
"chrIV","YDR142C (PEX7 PAS7 PEB1)","-",740347,740280,740444,164,"F-close-W",740280,740444,"chrIV"
"chrIV","YDR143C (SAN1)","-",741867,741747,741993,246,"F-open-W",741747,741993,"chrIV"
"chrIV","YDR144C (MKC7 YPS2)","-",744206,743974,744267,293,"W-open-W",743974,744267,"chrIV"
"chrIV","YDR145W (TAF12 TAF61 TAF68)","+",748491,748668,748311,357,"F-open-F",748311,748668,"chrIV"
"chrIV","YDR146C (SWI5)","-",748480,748311,748668,357,"F-open-F",748311,748668,"chrIV"
"chrIV","YDR147W (EKI1)","+",753272,753447,753170,277,"W-open-W",753170,753447,"chrIV"
"chrIV","YDR148C (KGD2)","-",753513,753447,753619,172,"W-close-W",753447,753619,"chrIV"
"chrIV","YDR150W (NUM1 PAC12)","+",763929,763915,763809,106,"F-overlap-F",763809,763915,"chrIV"
"chrIV","YDR151C (CTH1)","-",763980,763915,764093,178,"F-close-F",763915,764093,"chrIV"
"chrIV","YDR152W (GIR2)","+",766569,766670,766489,181,"F-close-W",766489,766670,"chrIV"
"chrIV","YDR153C (ENT5)","-",766621,766489,766670,181,"W-close-F",766489,766670,"chrIV"
"chrIV","YDR154C","-",768399,768391,768602,211,"F-close-F",768391,768602,"chrIV"
"chrIV","YDR155C (CPR1 CPH1 CYP1)","-",768404,768391,768602,211,"F-close-F",768391,768602,"chrIV"
"chrIV","YDR156W (RPA14)","+",770053,770323,769974,349,"F-open-F",769974,770323,"chrIV"
"chrIV","YDR157W","+",770750,770815,770650,165,"W-close-F",770650,770815,"chrIV"
"chrIV","YDR158W (HOM2)","+",771577,771559,771392,167,"W-close-F",771392,771559,"chrIV"
"chrIV","YDR159W (SAC3 LEP1)","+",775840,776043,775768,275,"W-open-W",775768,776043,"chrIV"
"chrIV","YDR160W (SSY1 SHR10)","+",778754,779038,778581,457,"W-open-W",778581,779038,"chrIV"
"chrIV","YDR161W","+",780288,780329,780156,173,"W-close-W",780156,780329,"chrIV"
"chrIV","YDR162C (NBP2)","-",780192,780156,780329,173,"W-close-W",780156,780329,"chrIV"
"chrIV","YDR163W (CWC15)","+",782055,782099,781929,170,"W-close-W",781929,782099,"chrIV"
"chrIV","YDR164C (SEC1)","-",781918,781929,782099,170,"W-close-W",781929,782099,"chrIV"
"chrIV","YDR165W (TRM82)","+",786287,786308,786150,158,"F-close-F",786150,786308,"chrIV"
"chrIV","YDR166C (SEC5)","-",786204,786150,786308,158,"F-close-F",786150,786308,"chrIV"
"chrIV","YDR167W (TAF10 TAF23 TAF25)","+",790169,790338,790118,220,"W-open-W",790118,790338,"chrIV"
"chrIV","YDR168W (CDC37 SMO1)","+",791950,792037,791920,117,"F-overlap-F",791920,792037,"chrIV"
"chrIV","YDR169C (STB3)","-",792047,792037,792144,107,"F-overlap-F",792037,792144,"chrIV"
"chrIV","YDR170C (SEC7)","-",795991,795822,796026,204,"W-close-W",795822,796026,"chrIV"
"chrIV","YDR171W (HSP42)","+",807832,808049,807791,258,"F-open-W",807791,808049,"chrIV"
"chrIV","YDR172W (SUP35 GST1 PNM2 SAL3 SUF12 SUP2 SUP36 %5BPSI(%2B)%5D %5BPSI%5D)","+",810532,810578,810329,249,"F-open-F",810329,810578,"chrIV"
"chrIV","YDR173C (ARG82 ARGR3 ARGRIII IPK2)","-",810425,810329,810578,249,"F-open-F",810329,810578,"chrIV"
"chrIV","YDR174W (HMO1 HSM2)","+",813068,813166,813018,148,"F-close-F",813018,813166,"chrIV"
"chrIV","YDR175C (RSM24)","-",813077,813018,813166,148,"F-close-F",813018,813166,"chrIV"
"chrIV","YDR176W (NGG1 ADA3 SWI7)","+",816615,816827,816535,292,"W-open-W",816535,816827,"chrIV"
"chrIV","YDR177W (UBC1)","+",817636,817652,817452,200,"W-close-F",817452,817652,"chrIV"
"chrIV","YDR178W (SDH4 ACN18)","+",818691,818839,818533,306,"W-open-F",818533,818839,"chrIV"
"chrIV","YDR179C (CSN9)","-",818585,818533,818839,306,"F-open-W",818533,818839,"chrIV"
"chrIV","YDR179W-A","+",820913,820930,820761,169,"W-close-W",820761,820930,"chrIV"
"chrIV","YDR180W (SCC2)","+",825827,825874,825799,75,"F-overlap-F",825799,825874,"chrIV"
"chrIV","YDR181C (SAS4)","-",825732,825653,825799,146,"F-close-F",825653,825799,"chrIV"
"chrIV","YDR182W (CDC1 DSC1 DSR1 ESP2)","+",829131,829203,829036,167,"W-close-W",829036,829203,"chrIV"
"chrIV","YDR182W-A","+",829509,829574,829373,201,"W-close-W",829373,829574,"chrIV"
"chrIV","YDR183W (PLP1)","+",830341,830378,830255,123,"W-close-W",830255,830378,"chrIV"
"chrIV","YDR184C (ATC1 LIC4)","-",830408,830378,830540,162,"W-close-W",830378,830540,"chrIV"
"chrIV","YDR185C (UPS3 GEP2)","-",831752,831540,831841,301,"W-open-W",831540,831841,"chrIV"
"chrIV","YDR186C","-",832737,832532,832801,269,"F-open-W",832532,832801,"chrIV"
"chrIV","YDR188W (CCT6 HTR3 TCP20 TCP6)","+",838224,838381,838089,292,"F-open-W",838089,838381,"chrIV"
"chrIV","YDR189W (SLY1)","+",840506,840561,840347,214,"F-close-F",840347,840561,"chrIV"
"chrIV","YDR190C (RVB1 TIH1 TIP49 TIP49A)","-",840527,840347,840561,214,"F-close-F",840347,840561,"chrIV"
"chrIV","YDR191W (HST4)","+",843558,843540,843432,108,"F-overlap-F",843432,843540,"chrIV"
"chrIV","YDR192C (NUP42 RIP1 UIP1)","-",843477,843432,843540,108,"F-overlap-F",843432,843540,"chrIV"
"chrIV","YDR194C (MSS116)","-",845797,845679,845848,169,"F-close-W",845679,845848,"chrIV"
"chrIV","YDR195W (REF2)","+",850284,850328,850105,223,"F-open-W",850105,850328,"chrIV"
"chrIV","YDR196C (CAB5)","-",850183,850105,850328,223,"W-open-F",850105,850328,"chrIV"
"chrIV","YDR197W (CBS2 CBP7)","+",852519,852505,852430,75,"F-overlap-F",852430,852505,"chrIV"
"chrIV","YDR198C (RKM2)","-",852490,852505,852668,163,"F-close-F",852505,852668,"chrIV"
"chrIV","YDR200C (VPS64 FAR9)","-",854147,853926,854218,292,"W-open-F",853926,854218,"chrIV"
"chrIV","YDR201W (SPC19)","+",856931,857005,856902,103,"F-overlap-W",856902,857005,"chrIV"
"chrIV","YDR202C (RAV2)","-",856845,856830,856902,72,"F-overlap-F",856830,856902,"chrIV"
"chrIV","YDR203W","+",858056,858163,857923,240,"W-open-W",857923,858163,"chrIV"
"chrIV","YDR204W (COQ4)","+",859260,859368,859113,255,"W-open-W",859113,859368,"chrIV"
"chrIV","YDR205W (MSC2)","+",861617,861768,861479,289,"W-open-W",861479,861768,"chrIV"
"chrIV","YDR206W (EBS1)","+",864870,865065,864784,281,"W-open-F",864784,865065,"chrIV"
"chrIV","YDR207C (UME6 CAR80 NIM2 RIM16)","-",864978,864784,865065,281,"F-open-W",864784,865065,"chrIV"
"chrIV","YDR208W (MSS4)","+",870684,870805,870571,234,"F-open-F",870571,870805,"chrIV"
"chrIV","YDR210W","+",871533,871599,871421,178,"W-close-F",871421,871599,"chrIV"
"chrIV","YDR211W (GCD6)","+",887025,887215,886921,294,"W-open-W",886921,887215,"chrIV"
"chrIV","YDR212W (TCP1 CCT1)","+",888999,889086,888881,205,"W-close-W",888881,889086,"chrIV"
"chrIV","YDR213W (UPC2 MOX4)","+",892532,892816,892400,416,"W-open-F",892400,892816,"chrIV"
"chrIV","YDR214W (AHA1)","+",894017,894221,893890,331,"W-open-F",893890,894221,"chrIV"
"chrIV","YDR215C","-",892654,892400,892816,416,"F-open-W",892400,892816,"chrIV"
"chrIV","YDR216W (ADR1)","+",899324,899411,899240,171,"F-close-F",899240,899411,"chrIV"
"chrIV","YDR217C (RAD9)","-",899502,899411,899628,217,"F-open-F",899411,899628,"chrIV"
"chrIV","YDR218C (SPR28)","-",903659,903464,903725,261,"F-open-W",903464,903725,"chrIV"
"chrIV","YDR219C (MFB1)","-",905255,905046,905301,255,"W-open-W",905046,905301,"chrIV"
"chrIV","YDR221W (GTB1)","+",909628,909888,909396,492,"F-open-W",909396,909888,"chrIV"
"chrIV","YDR222W","+",911452,911447,911272,175,"W-close-W",911272,911447,"chrIV"
"chrIV","YDR223W (CRF1)","+",913853,914024,913724,300,"W-open-W",913724,914024,"chrIV"
"chrIV","YDR224C (HTB1 SPT12)","-",914190,914175,914425,250,"F-open-F",914175,914425,"chrIV"
"chrIV","YDR225W (HTA1 H2A1 SPT11)","+",916092,916188,915943,245,"W-open-F",915943,916188,"chrIV"
"chrIV","YDR226W (ADK1 AKY1 AKY2)","+",917281,917506,917255,251,"F-open-W",917255,917506,"chrIV"
"chrIV","YDR227W (SIR4 ASD1 STE9 UTH2)","+",921813,921885,921702,183,"W-close-F",921702,921885,"chrIV"
"chrIV","YDR228C (PCF11)","-",921859,921702,921885,183,"F-close-W",921702,921885,"chrIV"
"chrIV","YDR229W (IVY1)","+",926200,926352,926149,203,"F-close-W",926149,926352,"chrIV"
"chrIV","YDR231C (COX20)","-",926133,926149,926352,203,"W-close-F",926149,926352,"chrIV"
"chrIV","YDR232W (HEM1 CYD1 OLE3)","+",929279,929304,929074,230,"F-open-F",929074,929304,"chrIV"
"chrIV","YDR233C (RTN1)","-",929341,929304,929458,154,"F-close-F",929304,929458,"chrIV"
"chrIV","YDR234W (LYS4 LYS3)","+",933320,933455,933258,197,"W-close-F",933258,933455,"chrIV"
"chrIV","YDR235W (PRP42 MUD16 SNU65)","+",935221,935259,935082,177,"W-close-W",935082,935259,"chrIV"
"chrIV","YDR236C (FMN1)","-",935127,935082,935259,177,"W-close-W",935082,935259,"chrIV"
"chrIV","YDR237W (MRPL7)","+",937619,937701,937495,206,"F-close-F",937495,937701,"chrIV"
"chrIV","YDR238C (SEC26)","-",937699,937701,937866,165,"F-close-F",937701,937866,"chrIV"
"chrIV","YDR239C","-",940981,940807,941103,296,"W-open-W",940807,941103,"chrIV"
"chrIV","YDR240C (SNU56 MUD10)","-",943615,943417,943663,246,"W-open-W",943417,943663,"chrIV"
"chrIV","YDR242W (AMD2)","+",948596,948642,948497,145,"F-close-F",948497,948642,"chrIV"
"chrIV","YDR243C (PRP28)","-",948183,948197,948344,147,"F-close-F",948197,948344,"chrIV"
"chrIV","YDR244W (PEX5 PAS10)","+",952528,952759,952475,284,"W-open-W",952475,952759,"chrIV"
"chrIV","YDR245W (MNN10 BED1 REC41 SLC2)","+",954132,954315,954056,259,"W-open-W",954056,954315,"chrIV"
"chrIV","YDR246W (TRS23)","+",955101,955089,954937,152,"F-close-W",954937,955089,"chrIV"
"chrIV","YDR247W (VHS1)","+",957763,957891,957686,205,"F-close-W",957686,957891,"chrIV"
"chrIV","YDR248C","-",957660,957523,957686,163,"F-close-F",957523,957686,"chrIV"
"chrIV","YDR249C","-",958562,958384,958595,211,"F-close-W",958384,958595,"chrIV"
"chrIV","YDR251W (PAM1)","+",963241,963259,963184,75,"W-overlap-F",963184,963259,"chrIV"
"chrIV","YDR252W (BTT1)","+",964507,964591,964394,197,"W-close-W",964394,964591,"chrIV"
"chrIV","YDR253C (MET32)","-",963910,963782,963948,166,"F-close-W",963782,963948,"chrIV"
"chrIV","YDR254W (CHL4 CTF17 MCM17)","+",967009,967130,966971,159,"F-close-W",966971,967130,"chrIV"
"chrIV","YDR255C (RMD5 GID2)","-",965810,965779,965871,92,"F-overlap-W",965779,965871,"chrIV"
"chrIV","YDR256C (CTA1)","-",967995,967805,968109,304,"F-open-W",967805,968109,"chrIV"
"chrIV","YDR257C (RKM4 RMS1 SET7)","-",969692,969608,969793,185,"W-close-W",969608,969793,"chrIV"
"chrIV","YDR258C (HSP78)","-",971702,971710,971872,162,"W-close-F",971710,971872,"chrIV"
"chrIV","YDR259C (YAP6 HAL7)","-",974487,974273,974623,350,"W-open-F",974273,974623,"chrIV"
"chrIV","YDR260C (SWM1)","-",976348,NA,NA,NA,"+1_missing",975917,976645,"chrIV"
"chrIV","YDR261C (EXG2)","-",977400,977235,977486,251,"W-open-W",977235,977486,"chrIV"
"chrIV","YDR261C-D","-",987184,987143,NA,NA,"-1_missing",987143,987529,"chrIV"
"chrIV","YDR262W","+",994148,994227,994114,113,"F-overlap-F",994114,994227,"chrIV"
"chrIV","YDR263C (DIN7 DIN3)","-",994088,993946,994114,168,"F-close-W",993946,994114,"chrIV"
"chrIV","YDR264C (AKR1)","-",995767,995729,995822,93,"W-overlap-F",995729,995822,"chrIV"
"chrIV","YDR265W (PEX10 PAS4)","+",1000064,1000097,1000010,87,"F-overlap-F",1000010,1000097,"chrIV"
"chrIV","YDR266C","-",999970,999869,1000010,141,"F-close-F",999869,1000010,"chrIV"
"chrIV","YDR267C (CIA1)","-",1002356,1002191,1002493,302,"W-open-W",1002191,1002493,"chrIV"
"chrIV","YDR268W (MSW1)","+",1005246,1005298,1005122,176,"W-close-W",1005122,1005298,"chrIV"
"chrIV","YDR270W (CCC2)","+",1008767,1009003,1008743,260,"F-open-W",1008743,1009003,"chrIV"
"chrIV","YDR272W (GLO2)","+",1009911,1009954,1009800,154,"F-close-F",1009800,1009954,"chrIV"
"chrIV","YDR273W (DON1)","+",1011306,1011293,1011211,82,"F-overlap-F",1011211,1011293,"chrIV"
"chrIV","YDR274C","-",1011241,1011211,1011293,82,"F-overlap-F",1011211,1011293,"chrIV"
"chrIV","YDR275W (BSC2)","+",1013244,1013300,1013147,153,"F-close-F",1013147,1013300,"chrIV"
"chrIV","YDR276C (PMP3 SNA1)","-",1013251,1013147,1013300,153,"F-close-F",1013147,1013300,"chrIV"
"chrIV","YDR277C (MTH1 BPC1 DGT1 HTR1)","-",1014200,1014147,1014336,189,"W-close-W",1014147,1014336,"chrIV"
"chrIV","YDR279W (RNH202)","+",1020453,1020667,1020379,288,"W-open-W",1020379,1020667,"chrIV"
"chrIV","YDR280W (RRP45)","+",1021768,1021750,1021633,117,"F-overlap-F",1021633,1021750,"chrIV"
"chrIV","YDR281C (PHM6)","-",1021819,1021750,1021925,175,"W-close-F",1021750,1021925,"chrIV"
"chrIV","YDR282C","-",1023319,1023172,1023478,306,"F-open-W",1023172,1023478,"chrIV"
"chrIV","YDR283C (GCN2 AAS1 AAS102 NDR2)","-",1024922,1024923,1025101,178,"W-close-W",1024923,1025101,"chrIV"
"chrIV","YDR284C (DPP1 ZRG1)","-",1030467,1030484,1030667,183,"W-close-F",1030484,1030667,"chrIV"
"chrIV","YDR285W (ZIP1)","+",1035219,1035227,1035042,185,"W-close-W",1035042,1035227,"chrIV"
"chrIV","YDR286C","-",1035145,1035042,1035227,185,"W-close-W",1035042,1035227,"chrIV"
"chrIV","YDR287W (INM2)","+",1036959,1036980,1036794,186,"W-close-F",1036794,1036980,"chrIV"
"chrIV","YDR288W (NSE3)","+",1038229,1038379,1038172,207,"F-close-W",1038172,1038379,"chrIV"
"chrIV","YDR289C (RTT103)","-",1038199,1038172,1038379,207,"W-close-F",1038172,1038379,"chrIV"
"chrIV","YDR291W (HRQ1)","+",1043097,1043255,1043072,183,"F-close-F",1043072,1043255,"chrIV"
"chrIV","YDR292C (SRP101)","-",1043040,1042867,1043072,205,"F-close-F",1042867,1043072,"chrIV"
"chrIV","YDR293C (SSD1 CLA1 MCS1 RLT1 SRK1)","-",1045335,1045125,1045454,329,"F-open-F",1045125,1045454,"chrIV"
"chrIV","YDR294C (DPL1 BST1)","-",1050405,1050201,1050504,303,"W-open-W",1050201,1050504,"chrIV"
"chrIV","YDR295C (HDA2 PLO2)","-",1052542,1052503,1052670,167,"W-close-W",1052503,1052670,"chrIV"
"chrIV","YDR296W (MHR1 XTC1)","+",1055979,1056086,1055841,245,"W-open-W",1055841,1056086,"chrIV"
"chrIV","YDR297W (SUR2 SYR2)","+",1057763,1057800,1057720,80,"F-overlap-W",1057720,1057800,"chrIV"
"chrIV","YDR298C (ATP5 OSC1)","-",1057999,1057800,1058170,370,"F-open-W",1057800,1058170,"chrIV"
"chrIV","YDR299W (BFR2)","+",1061325,1061385,1061257,128,"F-close-F",1061257,1061385,"chrIV"
"chrIV","YDR300C (PRO1)","-",1061395,1061385,1061503,118,"F-overlap-F",1061385,1061503,"chrIV"
"chrIV","YDR301W (CFT1 YHH1)","+",1067559,1067728,1067446,282,"W-open-W",1067446,1067728,"chrIV"
"chrIV","YDR302W (GPI11)","+",1068463,1068558,1068400,158,"W-close-F",1068400,1068558,"chrIV"
"chrIV","YDR303C (RSC3)","-",1068622,1068558,1068778,220,"F-open-F",1068558,1068778,"chrIV"
"chrIV","YDR304C (CPR5 CYP5)","-",1071800,1071692,1071909,217,"W-open-W",1071692,1071909,"chrIV"
"chrIV","YDR305C (HNT2 APH1)","-",1072681,1072546,1072812,266,"W-open-W",1072546,1072812,"chrIV"
"chrIV","YDR306C","-",1073640,1073654,1073825,171,"W-close-W",1073654,1073825,"chrIV"
"chrIV","YDR307W","+",1077989,1078109,1077954,155,"W-close-W",1077954,1078109,"chrIV"
"chrIV","YDR308C (SRB7 MED21)","-",1077886,1077763,1077954,191,"W-close-F",1077763,1077954,"chrIV"
"chrIV","YDR309C (GIC2)","-",1078739,1078688,1078860,172,"W-close-W",1078688,1078860,"chrIV"
"chrIV","YDR310C (SUM1)","-",1080933,1080818,1080997,179,"W-close-F",1080818,1080997,"chrIV"
"chrIV","YDR311W (TFB1)","+",1087095,1087322,1086993,329,"W-open-W",1086993,1087322,"chrIV"
"chrIV","YDR312W (SSF2)","+",1089124,1089258,1089064,194,"F-close-W",1089064,1089258,"chrIV"
"chrIV","YDR313C (PIB1)","-",1089041,1088982,1089064,82,"F-overlap-F",1088982,1089064,"chrIV"
"chrIV","YDR314C (RAD34)","-",1090326,1090088,1090396,308,"W-open-W",1090088,1090396,"chrIV"
"chrIV","YDR315C (IPK1 GSL1)","-",1092627,1092526,1092759,233,"W-open-W",1092526,1092759,"chrIV"
"chrIV","YDR316W (OMS1)","+",1095257,1095255,1095068,187,"W-close-W",1095068,1095255,"chrIV"
"chrIV","YDR317W (HIM1)","+",1103509,1103500,1103341,159,"W-close-W",1103341,1103500,"chrIV"
"chrIV","YDR318W (MCM21 CTF5)","+",1105057,1105163,1105025,138,"W-close-F",1105025,1105163,"chrIV"
"chrIV","YDR319C (FIT2A)","-",1104929,1104885,1105025,140,"W-close-F",1104885,1105025,"chrIV"
"chrIV","YDR320C (SWA2 AUX1 BUD24)","-",1106004,1105835,1106054,219,"W-open-F",1105835,1106054,"chrIV"
"chrIV","YDR320C-A (DAD4 HSK2)","-",1108193,1108087,1108306,219,"W-open-W",1108087,1108306,"chrIV"
"chrIV","YDR320W-B","+",1108684,1108718,1108449,269,"W-open-W",1108449,1108718,"chrIV"
"chrIV","YDR321W (ASP1)","+",1109952,1109994,1109805,189,"W-close-W",1109805,1109994,"chrIV"
"chrIV","YDR322C-A (TIM11 ATP21)","-",1111797,1111743,1111947,204,"W-close-F",1111743,1111947,"chrIV"
"chrIV","YDR322W (MRPL35)","+",1111798,1111947,1111743,204,"F-close-W",1111743,1111947,"chrIV"
"chrIV","YDR323C (PEP7 VAC1 VPL21 VPS19 VPT19)","-",1112333,1112263,1112552,289,"W-open-W",1112263,1112552,"chrIV"
"chrIV","YDR325W (YCG1 TIE1 YCS5)","+",1120330,1120514,1120230,284,"W-open-F",1120230,1120514,"chrIV"
"chrIV","YDR326C (YSP2)","-",1120464,1120230,1120514,284,"F-open-W",1120230,1120514,"chrIV"
"chrIV","YDR327W","+",1125860,1126011,1125833,178,"W-close-W",1125833,1126011,"chrIV"
"chrIV","YDR328C (SKP1 CBF3D MGO1)","-",1125241,1125064,1125363,299,"W-open-W",1125064,1125363,"chrIV"
"chrIV","YDR329C (PEX3 PAS3)","-",1126197,1126011,1126306,295,"W-open-W",1126011,1126306,"chrIV"
"chrIV","YDR330W (UBX5)","+",1129581,1129619,1129333,286,"W-open-W",1129333,1129619,"chrIV"
"chrIV","YDR331W (GPI8)","+",1130941,1131018,1130783,235,"F-open-W",1130783,1131018,"chrIV"
"chrIV","YDR332W (IRC3)","+",1133146,1133203,1133126,77,"F-overlap-F",1133126,1133203,"chrIV"
"chrIV","YDR333C","-",1133044,1133027,1133126,99,"F-overlap-W",1133027,1133126,"chrIV"
"chrIV","YDR334W (SWR1)","+",1140594,1140653,1140554,99,"W-overlap-F",1140554,1140653,"chrIV"
"chrIV","YDR335W (MSN5 KAP142 STE21)","+",1144932,1145131,1144863,268,"W-open-F",1144863,1145131,"chrIV"
"chrIV","YDR336W","+",1146102,1146316,1146067,249,"W-open-W",1146067,1146316,"chrIV"
"chrIV","YDR337W (MRPS28)","+",1147236,1147378,1147163,215,"F-close-F",1147163,1147378,"chrIV"
"chrIV","YDR338C","-",1147245,1147163,1147378,215,"F-close-F",1147163,1147378,"chrIV"
"chrIV","YDR339C (FCF1 UTP24)","-",1149860,1149744,1149965,221,"F-open-W",1149744,1149965,"chrIV"
"chrIV","YDR341C (RRS1)","-",1151706,1151594,1151781,187,"F-close-F",1151594,1151781,"chrIV"
"chrIV","YDR342C (HXT7)","-",1154074,1154075,1154266,191,"W-close-W",1154075,1154266,"chrIV"
"chrIV","YDR343C (HXT6)","-",1159448,NA,NA,NA,"+1_missing",1154266,1161518,"chrIV"
"chrIV","YDR345C (HXT3)","-",1162818,1162765,1162856,91,"F-overlap-F",1162765,1162856,"chrIV"
"chrIV","YDR346C (SVF1 SGI1)","-",1166938,1166879,1167064,185,"W-close-W",1166879,1167064,"chrIV"
"chrIV","YDR347W (MRP1)","+",1170260,1170287,1170098,189,"W-close-W",1170098,1170287,"chrIV"
"chrIV","YDR348C","-",1170152,1170098,1170287,189,"W-close-W",1170098,1170287,"chrIV"
"chrIV","YDR349C (YPS7)","-",1172264,1172028,1172301,273,"W-open-W",1172028,1172301,"chrIV"
"chrIV","YDR350C (ATP22 TCM10)","-",1176045,1175866,1176069,203,"F-close-F",1175866,1176069,"chrIV"
"chrIV","YDR351W (SBE2)","+",1181405,1181654,1181367,287,"F-open-W",1181367,1181654,"chrIV"
"chrIV","YDR352W","+",1182991,1182983,1182818,165,"W-close-W",1182818,1182983,"chrIV"
"chrIV","YDR353W (TRR1)","+",1184361,1184420,1184221,199,"F-close-W",1184221,1184420,"chrIV"
"chrIV","YDR354C-A","-",1184629,1184420,1184681,261,"W-open-W",1184420,1184681,"chrIV"
"chrIV","YDR354W (TRP4)","+",1185958,1186127,1185841,286,"W-open-W",1185841,1186127,"chrIV"
"chrIV","YDR356W (SPC110 NUF1 XCM1)","+",1189236,1189363,1189100,263,"W-open-W",1189100,1189363,"chrIV"
"chrIV","YDR357C (CNL1 BLC1)","-",1189132,1189100,1189363,263,"W-open-W",1189100,1189363,"chrIV"
"chrIV","YDR358W (GGA1)","+",1191893,1192006,1191701,305,"F-open-F",1191701,1192006,"chrIV"
"chrIV","YDR359C (EAF1 VID21)","-",1191787,1191701,1192006,305,"F-open-F",1191701,1192006,"chrIV"
"chrIV","YDR361C (BCP1)","-",1195181,1195115,1195446,331,"W-open-W",1195115,1195446,"chrIV"
"chrIV","YDR362C (TFC6)","-",1196628,1196564,1196739,175,"W-close-W",1196564,1196739,"chrIV"
"chrIV","YDR363W (ESC2)","+",1201372,1201438,1201252,186,"W-close-W",1201252,1201438,"chrIV"
"chrIV","YDR363W-A (SEM1 DSS1 HOD1)","+",1202575,1202659,1202473,186,"F-close-F",1202473,1202659,"chrIV"
"chrIV","YDR364C (CDC40 PRP17 SLT15 SLU4)","-",1202440,1202309,1202473,164,"F-close-W",1202309,1202473,"chrIV"
"chrIV","YDR365C (ESF1)","-",1204410,1204417,1204582,165,"W-close-F",1204417,1204582,"chrIV"
"chrIV","YDR367W (KEI1)","+",1213660,1213882,1213598,284,"W-open-F",1213598,1213882,"chrIV"
"chrIV","YDR368W (YPR1)","+",1215004,1215095,1214944,151,"F-close-F",1214944,1215095,"chrIV"
"chrIV","YDR369C (XRS2)","-",1214910,1214854,1214944,90,"F-overlap-F",1214854,1214944,"chrIV"
"chrIV","YDR370C","-",1217728,1217576,1217777,201,"W-close-W",1217576,1217777,"chrIV"
"chrIV","YDR371W (CTS2)","+",1221056,1221156,1220858,298,"F-open-F",1220858,1221156,"chrIV"
"chrIV","YDR372C (VPS74 API1 MNN3)","-",1220959,1220858,1221156,298,"F-open-F",1220858,1221156,"chrIV"
"chrIV","YDR373W (FRQ1)","+",1223437,1223663,1223318,345,"F-open-W",1223318,1223663,"chrIV"
"chrIV","YDR374C","-",1223457,1223318,1223663,345,"W-open-F",1223318,1223663,"chrIV"
"chrIV","YDR374W-A","+",1225199,1225320,1225152,168,"W-close-F",1225152,1225320,"chrIV"
"chrIV","YDR375C (BCS1)","-",1225101,1224969,1225152,183,"W-close-W",1224969,1225152,"chrIV"
"chrIV","YDR376W (ARH1)","+",1228375,1228572,1228282,290,"W-open-W",1228282,1228572,"chrIV"
"chrIV","YDR377W (ATP17)","+",1229216,1229248,1229059,189,"W-close-W",1229059,1229248,"chrIV"
"chrIV","YDR378C (LSM6)","-",1229159,1229059,1229248,189,"W-close-W",1229059,1229248,"chrIV"
"chrIV","YDR379C-A","-",1233139,1233145,1233356,211,"F-close-W",1233145,1233356,"chrIV"
"chrIV","YDR379W (RGA2)","+",1233279,1233356,1233145,211,"W-close-F",1233145,1233356,"chrIV"
"chrIV","YDR380W (ARO10)","+",1236253,1236532,1236151,381,"W-open-W",1236151,1236532,"chrIV"
"chrIV","YDR381C-A","-",1238194,1238141,1238304,163,"F-close-F",1238141,1238304,"chrIV"
"chrIV","YDR381W (YRA1 SHE11)","+",1238196,1238304,1238141,163,"F-close-F",1238141,1238304,"chrIV"
"chrIV","YDR382W (RPP2B RPL45 YPA1)","+",1239975,1240132,1239932,200,"F-close-W",1239932,1240132,"chrIV"
"chrIV","YDR383C (NKP1)","-",1239893,1239759,1239932,173,"F-close-W",1239759,1239932,"chrIV"
"chrIV","YDR384C (ATO3)","-",1241043,1241061,1241292,231,"F-open-F",1241061,1241292,"chrIV"
"chrIV","YDR385W (EFT2)","+",1245920,1245972,1245860,112,"W-overlap-F",1245860,1245972,"chrIV"
"chrIV","YDR386W (MUS81 SLX3)","+",1248091,1248152,1247920,232,"F-open-F",1247920,1248152,"chrIV"
"chrIV","YDR387C","-",1247989,1247920,1248152,232,"F-open-F",1247920,1248152,"chrIV"
"chrIV","YDR388W (RVS167)","+",1251755,1252048,1251604,444,"W-open-W",1251604,1252048,"chrIV"
"chrIV","YDR389W (SAC7)","+",1254696,1254822,1254661,161,"F-close-W",1254661,1254822,"chrIV"
"chrIV","YDR390C (UBA2 UAL1)","-",1254868,1254822,1254923,101,"F-overlap-W",1254822,1254923,"chrIV"
"chrIV","YDR391C","-",1257277,1257241,1257410,169,"W-close-W",1257241,1257410,"chrIV"
"chrIV","YDR392W (SPT3)","+",1259839,1259874,1259635,239,"W-open-W",1259635,1259874,"chrIV"
"chrIV","YDR393W (SHE9 MDM33)","+",1261433,1261631,1261351,280,"W-open-W",1261351,1261631,"chrIV"
"chrIV","YDR394W (RPT3 YNT1 YTA2)","+",1263054,1263263,1262955,308,"W-open-W",1262955,1263263,"chrIV"
"chrIV","YDR395W (SXM1 KAP108)","+",1266255,1266335,1266133,202,"W-close-W",1266133,1266335,"chrIV"
"chrIV","YDR396W","+",1267427,1267467,1267142,325,"W-open-W",1267142,1267467,"chrIV"
"chrIV","YDR397C (NCB2 YDR1)","-",1266268,1266133,1266335,202,"W-close-W",1266133,1266335,"chrIV"
"chrIV","YDR398W (UTP5)","+",1269508,1269501,1269361,140,"F-close-F",1269361,1269501,"chrIV"
"chrIV","YDR399W (HPT1 BRA6 HPRT)","+",1270846,1270927,1270801,126,"F-close-F",1270801,1270927,"chrIV"
"chrIV","YDR400W (URH1)","+",1272254,1272369,1272215,154,"F-close-W",1272215,1272369,"chrIV"
"chrIV","YDR402C (DIT2 CYP56)","-",1272089,1272032,1272215,183,"F-close-W",1272032,1272215,"chrIV"
"chrIV","YDR403W (DIT1)","+",1276370,1276422,1276179,243,"W-open-W",1276179,1276422,"chrIV"
"chrIV","YDR404C (RPB7)","-",1276491,1276422,1276643,221,"W-open-W",1276422,1276643,"chrIV"
"chrIV","YDR405W (MRP20 MRPL41)","+",1278545,1278651,1278442,209,"F-close-W",1278442,1278651,"chrIV"
"chrIV","YDR406W (PDR15)","+",1283880,1283921,1283825,96,"F-overlap-F",1283825,1283921,"chrIV"
"chrIV","YDR407C (TRS120)","-",1284000,1283921,1284062,141,"F-close-F",1283921,1284062,"chrIV"
"chrIV","YDR408C (ADE8)","-",1288101,1287990,1288296,306,"W-open-W",1287990,1288296,"chrIV"
"chrIV","YDR409W (SIZ1 ULL1)","+",1292389,1292587,1292314,273,"F-open-F",1292314,1292587,"chrIV"
"chrIV","YDR410C (STE14)","-",1292274,1292125,1292314,189,"F-close-F",1292125,1292314,"chrIV"
"chrIV","YDR411C (DFM1)","-",1293305,1293123,1293408,285,"W-open-W",1293123,1293408,"chrIV"
"chrIV","YDR412W (RRP17)","+",1295546,1295589,1295383,206,"W-close-W",1295383,1295589,"chrIV"
"chrIV","YDR414C (ERD1 LDB2)","-",1295445,1295383,1295589,206,"W-close-W",1295383,1295589,"chrIV"
"chrIV","YDR415C","-",1296943,1296832,1297071,239,"W-open-W",1296832,1297071,"chrIV"
"chrIV","YDR416W (SYF1 NTC90)","+",1301043,1301227,1300953,274,"W-open-W",1300953,1301227,"chrIV"
"chrIV","YDR417C","-",1301290,1301227,NA,NA,"-1_missing",1301227,1301628,"chrIV"
"chrIV","YDR418W (RPL12B)","+",1302204,1302290,1302095,195,"F-close-W",1302095,1302290,"chrIV"
"chrIV","YDR419W (RAD30 DBH1)","+",1305422,1305478,1305396,82,"F-overlap-W",1305396,1305478,"chrIV"
"chrIV","YDR420W (HKR1)","+",1311876,1312018,1311757,261,"W-open-W",1311757,1312018,"chrIV"
"chrIV","YDR421W (ARO80)","+",1314921,1314959,1314848,111,"F-overlap-F",1314848,1314959,"chrIV"
"chrIV","YDR422C (SIP1)","-",1315036,1314959,1315090,131,"F-close-F",1314959,1315090,"chrIV"
"chrIV","YDR423C (CAD1 YAP2)","-",1317977,1317834,1318111,277,"W-open-W",1317834,1318111,"chrIV"
"chrIV","YDR424C (DYN2 SLC1)","-",1319344,1319209,1319482,273,"W-open-W",1319209,1319482,"chrIV"
"chrIV","YDR425W (SNX41)","+",1322052,1322227,1321925,302,"W-open-W",1321925,1322227,"chrIV"
"chrIV","YDR426C","-",1321546,1321474,1321611,137,"W-close-W",1321474,1321611,"chrIV"
"chrIV","YDR427W (RPN9)","+",1323483,1323555,1323329,226,"W-open-F",1323329,1323555,"chrIV"
"chrIV","YDR428C (BNA7)","-",1323347,1323329,1323555,226,"F-open-W",1323329,1323555,"chrIV"
"chrIV","YDR429C (TIF35)","-",1324360,1324221,1324448,227,"F-open-F",1324221,1324448,"chrIV"
"chrIV","YDR430C (CYM1 MOP112)","-",1325450,1325277,1325552,275,"W-open-W",1325277,1325552,"chrIV"
"chrIV","YDR432W (NPL3 MTR13 MTS1 NAB1 NOP3)","+",1330246,1330325,1330133,192,"F-close-F",1330133,1330325,"chrIV"
"chrIV","YDR434W (GPI17)","+",1332956,1332945,1332801,144,"F-close-F",1332801,1332945,"chrIV"
"chrIV","YDR435C (PPM1)","-",1332827,1332801,1332945,144,"F-close-F",1332801,1332945,"chrIV"
"chrIV","YDR436W (PPZ2)","+",1337115,1337098,1336905,193,"W-close-W",1336905,1337098,"chrIV"
"chrIV","YDR437W (GPI19)","+",1337957,1338055,1337840,215,"W-close-W",1337840,1338055,"chrIV"
"chrIV","YDR438W (THI74)","+",1339481,1339618,1339413,205,"W-close-W",1339413,1339618,"chrIV"
"chrIV","YDR439W (LRS4)","+",1340859,1340893,1340808,85,"F-overlap-F",1340808,1340893,"chrIV"
"chrIV","YDR440W (DOT1 PCH1)","+",1344344,1344370,1344178,192,"W-close-F",1344178,1344370,"chrIV"
"chrIV","YDR441C (APT2)","-",1344273,1344178,1344370,192,"F-close-W",1344178,1344370,"chrIV"
"chrIV","YDR442W","+",1346751,1346739,1346652,87,"F-overlap-W",1346652,1346739,"chrIV"
"chrIV","YDR443C (SSN2 MED13 NUT8 RYE3 SCA1 SRB9 UME2)","-",1345143,1345021,1345183,162,"F-close-W",1345021,1345183,"chrIV"
"chrIV","YDR444W","+",1352398,1352686,1352344,342,"F-open-W",1352344,1352686,"chrIV"
"chrIV","YDR446W (ECM11)","+",1355225,1355257,1355087,170,"W-close-W",1355087,1355257,"chrIV"
"chrIV","YDR447C (RPS17B RP51B RPL51B)","-",1354689,1354632,1354824,192,"F-close-W",1354632,1354824,"chrIV"
"chrIV","YDR448W (ADA2 SWI8)","+",1357472,1357606,1357393,213,"W-close-W",1357393,1357606,"chrIV"
"chrIV","YDR449C (UTP6)","-",1357510,1357393,1357606,213,"W-close-W",1357393,1357606,"chrIV"
"chrIV","YDR450W (RPS18A)","+",1360913,1360898,1360725,173,"W-close-F",1360725,1360898,"chrIV"
"chrIV","YDR451C (YHP1)","-",1360938,1360898,1360978,80,"F-overlap-F",1360898,1360978,"chrIV"
"chrIV","YDR452W (PPN1 PHM5)","+",1365053,1365174,1365013,161,"W-close-W",1365013,1365174,"chrIV"
"chrIV","YDR453C (TSA2)","-",1364985,1364836,1365013,177,"W-close-F",1364836,1365013,"chrIV"
"chrIV","YDR454C (GUK1 PUR5)","-",1366161,1366157,1366334,177,"W-close-W",1366157,1366334,"chrIV"
"chrIV","YDR456W (NHX1 NHA2 VPL27 VPS44)","+",1369492,1369704,1369426,278,"W-open-W",1369426,1369704,"chrIV"
"chrIV","YDR457W (TOM1)","+",1379687,1379717,1379643,74,"F-overlap-F",1379643,1379717,"chrIV"
"chrIV","YDR458C (HEH2)","-",1379881,1379827,1379911,84,"F-overlap-F",1379827,1379911,"chrIV"
"chrIV","YDR459C (PFA5)","-",1382211,1382062,1382314,252,"W-open-W",1382062,1382314,"chrIV"
"chrIV","YDR460W (TFB3 RIG2)","+",1384876,1385093,1384831,262,"W-open-W",1384831,1385093,"chrIV"
"chrIV","YDR461C-A","-",1385356,1385256,1385416,160,"F-close-W",1385256,1385416,"chrIV"
"chrIV","YDR461W (MFA1)","+",1385434,1385416,1385256,160,"W-close-F",1385256,1385416,"chrIV"
"chrIV","YDR462W (MRPL28)","+",1386648,1386831,1386527,304,"W-open-W",1386527,1386831,"chrIV"
"chrIV","YDR463W (STP1 BAP1 SSY2)","+",1388578,1388796,1388531,265,"W-open-F",1388531,1388796,"chrIV"
"chrIV","YDR464W (SPP41)","+",1393349,1393382,1393193,189,"F-close-F",1393193,1393382,"chrIV"
"chrIV","YDR465C (RMT2)","-",1393186,1393193,1393382,189,"F-close-F",1393193,1393382,"chrIV"
"chrIV","YDR466W (PKH3)","+",1397995,1398124,1397942,182,"F-close-F",1397942,1398124,"chrIV"
"chrIV","YDR468C (TLG1)","-",1397926,1397942,1398124,182,"F-close-F",1397942,1398124,"chrIV"
"chrIV","YDR469W (SDC1 CPS25 SAF19)","+",1399628,1399734,1399551,183,"F-close-F",1399551,1399734,"chrIV"
"chrIV","YDR470C (UGO1)","-",1399531,1399391,1399551,160,"F-close-W",1399391,1399551,"chrIV"
"chrIV","YDR471W (RPL27B)","+",1402681,1402682,1402485,197,"W-close-W",1402485,1402682,"chrIV"
"chrIV","YDR472W (TRS31)","+",1404297,1404495,1404234,261,"W-open-W",1404234,1404495,"chrIV"
"chrIV","YDR473C (PRP3 RNA3)","-",1404348,1404234,1404495,261,"W-open-W",1404234,1404495,"chrIV"
"chrIV","YDR475C (JIP4 YDR474C)","-",1407353,1407269,1407499,230,"F-open-W",1407269,1407499,"chrIV"
"chrIV","YDR476C","-",1410251,1410088,1410308,220,"W-open-F",1410088,1410308,"chrIV"
"chrIV","YDR477W (SNF1 CAT1 CCR1 GLC2 HAF3 PAS14)","+",1414411,1414604,1414323,281,"F-open-W",1414323,1414604,"chrIV"
"chrIV","YDR478W (SNM1)","+",1415383,1415447,1415298,149,"F-close-F",1415298,1415447,"chrIV"
"chrIV","YDR479C (PEX29)","-",1415126,1415093,1415226,133,"F-close-W",1415093,1415226,"chrIV"
"chrIV","YDR480W (DIG2 RST2)","+",1418506,1418593,1418393,200,"W-close-W",1418393,1418593,"chrIV"
"chrIV","YDR481C (PHO8 phoH)","-",1418493,1418393,1418593,200,"W-close-W",1418393,1418593,"chrIV"
"chrIV","YDR482C (CWC21)","-",1420327,1420275,1420531,256,"W-open-W",1420275,1420531,"chrIV"
"chrIV","YDR483W (KRE2 MNT1)","+",1422597,1422715,1422518,197,"F-close-F",1422518,1422715,"chrIV"
"chrIV","YDR484W (VPS52 SAC2)","+",1424793,1424908,1424738,170,"F-close-F",1424738,1424908,"chrIV"
"chrIV","YDR485C (VPS72 SWC2)","-",1424668,1424626,1424738,112,"F-overlap-F",1424626,1424738,"chrIV"
"chrIV","YDR486C (VPS60 CHM5 MOS10)","-",1427287,1427179,1427427,248,"W-open-W",1427179,1427427,"chrIV"
"chrIV","YDR487C (RIB3)","-",1428250,1428097,1428362,265,"W-open-W",1428097,1428362,"chrIV"
"chrIV","YDR488C (PAC11)","-",1429029,1428993,NA,NA,"-1_missing",1428993,1429535,"chrIV"
"chrIV","YDR489W (SLD5 CDC105)","+",1432227,1432286,1432198,88,"F-overlap-F",1432198,1432286,"chrIV"
"chrIV","YDR490C (PKH1)","-",1431869,1431851,1432080,229,"F-open-W",1431851,1432080,"chrIV"
"chrIV","YDR492W (IZH1)","+",1435960,1436152,1435937,215,"F-close-F",1435937,1436152,"chrIV"
"chrIV","YDR493W (MZM1 AIM8 FMP36)","+",1436700,1436918,1436647,271,"W-open-W",1436647,1436918,"chrIV"
"chrIV","YDR494W (RSM28)","+",1438092,1438082,1437917,165,"W-close-F",1437917,1438082,"chrIV"
"chrIV","YDR495C (VPS3 PEP6 VPL3 VPT17)","-",1437964,1437917,1438082,165,"F-close-W",1437917,1438082,"chrIV"
"chrIV","YDR496C (PUF6)","-",1441359,1441165,1441440,275,"W-open-W",1441165,1441440,"chrIV"
"chrIV","YDR497C (ITR1)","-",1443610,1443390,1443674,284,"F-open-W",1443390,1443674,"chrIV"
"chrIV","YDR498C (SEC20)","-",1445793,1445758,1445831,73,"W-overlap-F",1445758,1445831,"chrIV"
"chrIV","YDR499W (LCD1 DDC2 PIE1)","+",1450171,1450229,1450048,181,"W-close-F",1450048,1450229,"chrIV"
"chrIV","YDR500C (RPL37B)","-",1450101,1450048,1450229,181,"F-close-W",1450048,1450229,"chrIV"
"chrIV","YDR501W (PLM2)","+",1453109,1453232,1453025,207,"W-close-F",1453025,1453232,"chrIV"
"chrIV","YDR502C (SAM2 ETH2)","-",1453017,1453025,1453232,207,"F-close-W",1453025,1453232,"chrIV"
"chrIV","YDR503C (LPP1)","-",1454870,1454584,1454909,325,"F-open-W",1454584,1454909,"chrIV"
"chrIV","YDR504C (SPG3)","-",1456080,1455897,1456118,221,"W-open-W",1455897,1456118,"chrIV"
"chrIV","YDR506C","-",1459304,1459234,1459423,189,"F-close-W",1459234,1459423,"chrIV"
"chrIV","YDR507C (GIN4 ERC47)","-",1462177,1461961,1462220,259,"F-open-W",1461961,1462220,"chrIV"
"chrIV","YDR508C (GNP1)","-",1466259,1466206,1466391,185,"W-close-W",1466206,1466391,"chrIV"
"chrIV","YDR510W (SMT3)","+",1469847,1469836,1469681,155,"W-close-F",1469681,1469836,"chrIV"
"chrIV","YDR511W (ACN9)","+",1470501,1470572,1470373,199,"W-close-W",1470373,1470572,"chrIV"
"chrIV","YDR512C (EMI1)","-",1470406,1470373,1470572,199,"W-close-W",1470373,1470572,"chrIV"
"chrIV","YDR513W (GRX2 TTR1)","+",1471543,1471582,1471363,219,"W-open-W",1471363,1471582,"chrIV"
"chrIV","YDR514C","-",1471457,1471363,1471582,219,"W-open-W",1471363,1471582,"chrIV"
"chrIV","YDR515W (SLF1 SRO99)","+",1474873,1474894,1474694,200,"W-close-F",1474694,1474894,"chrIV"
"chrIV","YDR516C (EMI2)","-",1474861,1474694,1474894,200,"F-close-W",1474694,1474894,"chrIV"
"chrIV","YDR517W (GRH1)","+",1478460,1478626,1478327,299,"W-open-W",1478327,1478626,"chrIV"
"chrIV","YDR518W (EUG1)","+",1480211,1480434,1480146,288,"W-open-W",1480146,1480434,"chrIV"
"chrIV","YDR519W (FPR2 FKB2)","+",1481057,1481119,1480910,209,"W-close-W",1480910,1481119,"chrIV"
"chrIV","YDR520C (URC2 RRT4)","-",1480950,1480910,1481119,209,"W-close-W",1480910,1481119,"chrIV"
"chrIV","YDR523C (SPS1)","-",1485437,1485240,1485465,225,"W-open-W",1485240,1485465,"chrIV"
"chrIV","YDR524C (AGE1 SAT1)","-",1487265,1487163,1487336,173,"W-close-F",1487163,1487336,"chrIV"
"chrIV","YDR524C-B","-",1489301,NA,NA,NA,"+1_missing",1488993,1489395,"chrIV"
"chrIV","YDR524W-C (YDR524W-A)","+",1489936,NA,NA,NA,"+1_missing",1489868,1490579,"chrIV"
"chrIV","YDR525W (API2)","+",1491032,1491099,1490746,353,"W-open-W",1490746,1491099,"chrIV"
"chrIV","YDR525W-A (SNA2)","+",1491062,1491099,NA,NA,"-1_missing",1490746,1491099,"chrIV"
"chrIV","YDR527W (RBA50)","+",1492501,1492591,1492430,161,"W-close-W",1492430,1492591,"chrIV"
"chrIV","YDR528W (HLR1)","+",1495961,1496062,1495869,193,"F-close-F",1495869,1496062,"chrIV"
"chrIV","YDR529C (QCR7 COR4 CRO1 UCR7)","-",1495960,1495869,1496062,193,"F-close-F",1495869,1496062,"chrIV"
"chrIV","YDR530C (APA2)","-",1496657,1496567,1496858,291,"W-open-W",1496567,1496858,"chrIV"
"chrIV","YDR531W (CAB1)","+",1499413,1499516,1499326,190,"F-close-F",1499326,1499516,"chrIV"
"chrIV","YDR532C (KRE28)","-",1499334,1499326,1499516,190,"F-close-F",1499326,1499516,"chrIV"
"chrIV","YDR533C (HSP31)","-",1501351,1501330,1501501,171,"W-close-F",1501330,1501501,"chrIV"
"chrIV","YDR534C (FIT1)","-",1503075,1503075,1503270,195,"F-close-W",1503075,1503270,"chrIV"
"chrIV","YDR535C","-",1504957,1504906,1504993,87,"F-overlap-F",1504906,1504993,"chrIV"
"chrIV","YDR536W (STL1)","+",1509860,1510033,1509595,438,"W-open-W",1509595,1510033,"chrIV"
"chrIV","YDR537C","-",1510822,1510838,1510907,69,"F-overlap-F",1510838,1510907,"chrIV"
"chrIV","YDR538W (PAD1 POF1)","+",1511861,1511919,1511765,154,"W-close-F",1511765,1511919,"chrIV"
"chrIV","YDR539W (FDC1)","+",1513698,1513744,1513613,131,"F-close-W",1513613,1513744,"chrIV"
"chrIV","YDR540C (IRC4)","-",1516817,1516787,1516955,168,"W-close-W",1516787,1516955,"chrIV"
"chrIV","YDR541C","-",1519437,1519415,1519596,181,"F-close-W",1519415,1519596,"chrIV"
"chrIX","YIL001W","+",355540,355701,355424,277,"F-open-W",355424,355701,"chrIX"
"chrIX","YIL002C (INP51 SJL1)","-",350435,350329,350484,155,"W-close-W",350329,350484,"chrIX"
"chrIX","YIL002W-A","+",350641,350671,350484,187,"W-close-W",350484,350671,"chrIX"
"chrIX","YIL003W (CFD1 DRE3)","+",350088,350329,350046,283,"F-open-W",350046,350329,"chrIX"
"chrIX","YIL004C (BET1 SLY12)","-",347814,347624,347853,229,"F-open-W",347624,347853,"chrIX"
"chrIX","YIL005W (EPS1)","+",347962,348011,347853,158,"F-close-W",347853,348011,"chrIX"
"chrIX","YIL006W (YIA6 NDT1)","+",345425,345606,345363,243,"W-open-W",345363,345606,"chrIX"
"chrIX","YIL007C (NAS2)","-",342840,342854,343029,175,"F-close-W",342854,343029,"chrIX"
"chrIX","YIL008W (URM1)","+",342965,343029,342854,175,"W-close-F",342854,343029,"chrIX"
"chrIX","YIL009C-A (EST3)","-",335572,335541,335713,172,"W-close-W",335541,335713,"chrIX"
"chrIX","YIL009W (FAA3)","+",341663,341716,341494,222,"F-open-W",341494,341716,"chrIX"
"chrIX","YIL010W (DOT5)","+",335708,335713,335541,172,"W-close-W",335541,335713,"chrIX"
"chrIX","YIL011W (TIR3 YIB1)","+",334659,334660,334449,211,"W-close-F",334449,334660,"chrIX"
"chrIX","YIL013C (PDR11)","-",328014,327947,328114,167,"F-close-F",327947,328114,"chrIX"
"chrIX","YIL014C-A (YIL015C-A)","-",325001,324895,325090,195,"W-close-W",324895,325090,"chrIX"
"chrIX","YIL014W (MNT3)","+",328109,328114,327947,167,"F-close-F",327947,328114,"chrIX"
"chrIX","YIL015W (BAR1 SST1)","+",324181,324195,324005,190,"W-close-F",324005,324195,"chrIX"
"chrIX","YIL016W (SNL1)","+",321998,322213,321941,272,"W-open-W",321941,322213,"chrIX"
"chrIX","YIL017C (VID28 GID5 YIL017W)","-",318083,318080,318247,167,"F-close-F",318080,318247,"chrIX"
"chrIX","YIL018W (RPL2B LOT2 RPL5A)","+",318032,318080,317896,184,"F-close-F",317896,318080,"chrIX"
"chrIX","YIL019W (FAF1)","+",316306,NA,NA,NA,"+1_missing",316224,316756,"chrIX"
"chrIX","YIL020C (HIS6)","-",313928,313852,314134,282,"F-open-F",313852,314134,"chrIX"
"chrIX","YIL021C-A","-",312588,312572,312878,306,"W-open-W",312572,312878,"chrIX"
"chrIX","YIL021W (RPB3)","+",313996,314134,313852,282,"F-open-F",313852,314134,"chrIX"
"chrIX","YIL022W (TIM44 ISP45 MIM44 MPI1)","+",312688,312878,312572,306,"W-open-W",312572,312878,"chrIX"
"chrIX","YIL023C (YKE4)","-",309264,309238,309434,196,"W-close-F",309238,309434,"chrIX"
"chrIX","YIL024C","-",308508,308370,308701,331,"W-open-W",308370,308701,"chrIX"
"chrIX","YIL026C (IRR1 SCC3)","-",304345,304358,304545,187,"W-close-F",304358,304545,"chrIX"
"chrIX","YIL027C (KRE27 EMC5)","-",303570,303584,303767,183,"W-close-W",303584,303767,"chrIX"
"chrIX","YIL028W","+",303364,303441,303275,166,"F-close-W",303275,303441,"chrIX"
"chrIX","YIL029C","-",300447,NA,NA,NA,"+1_missing",300030,300470,"chrIX"
"chrIX","YIL030C (SSM4 DOA10 KIS3)","-",295971,NA,NA,NA,"+1_missing",295664,296031,"chrIX"
"chrIX","YIL033C (BCY1 SRA1)","-",290247,290055,290319,264,"W-open-W",290055,290319,"chrIX"
"chrIX","YIL034C (CAP2)","-",289154,288991,289287,296,"W-open-W",288991,289287,"chrIX"
"chrIX","YIL035C (CKA1)","-",287530,287496,287651,155,"F-close-F",287496,287651,"chrIX"
"chrIX","YIL036W (CST6 ACA2 SHF1)","+",287558,287651,287496,155,"F-close-F",287496,287651,"chrIX"
"chrIX","YIL037C (PRM2)","-",283006,282862,283130,268,"W-open-W",282862,283130,"chrIX"
"chrIX","YIL038C (NOT3)","-",279977,279927,280151,224,"F-open-F",279927,280151,"chrIX"
"chrIX","YIL039W (TED1)","+",279946,279927,279722,205,"F-close-F",279722,279927,"chrIX"
"chrIX","YIL040W (APQ12)","+",278231,278275,278199,76,"F-overlap-W",278199,278275,"chrIX"
"chrIX","YIL041W (GVP36)","+",277595,277750,277556,194,"W-close-W",277556,277750,"chrIX"
"chrIX","YIL042C (PKP1)","-",274998,274889,275141,252,"W-open-F",274889,275141,"chrIX"
"chrIX","YIL043C (CBR1 CBR5)","-",273967,273831,274110,279,"W-open-W",273831,274110,"chrIX"
"chrIX","YIL044C (AGE2 SAT2)","-",272835,272712,273026,314,"F-open-F",272712,273026,"chrIX"
"chrIX","YIL045W (PIG2)","+",272921,273026,272712,314,"F-open-F",272712,273026,"chrIX"
"chrIX","YIL046W (MET30 ZRG11)","+",270686,270728,270651,77,"F-overlap-F",270651,270728,"chrIX"
"chrIX","YIL046W-A","+",268541,268654,268367,287,"F-open-W",268367,268654,"chrIX"
"chrIX","YIL047C (SYG1)","-",264701,264639,264785,146,"F-close-F",264639,264785,"chrIX"
"chrIX","YIL048W (NEO1)","+",265027,265226,264857,369,"F-open-F",264857,265226,"chrIX"
"chrIX","YIL049W (DFG10)","+",260988,261166,260910,256,"W-open-W",260910,261166,"chrIX"
"chrIX","YIL050W (PCL7)","+",259906,259943,259763,180,"W-close-W",259763,259943,"chrIX"
"chrIX","YIL051C (MMF1 IBM1)","-",257718,257677,257889,212,"F-close-W",257677,257889,"chrIX"
"chrIX","YIL052C (RPL34B)","-",256138,256076,256209,133,"F-close-F",256076,256209,"chrIX"
"chrIX","YIL053W (RHR2 GPP1)","+",256020,256076,255771,305,"W-open-F",255771,256076,"chrIX"
"chrIX","YIL054W","+",255017,255011,254791,220,"W-open-F",254791,255011,"chrIX"
"chrIX","YIL055C","-",251987,251833,252026,193,"F-close-W",251833,252026,"chrIX"
"chrIX","YIL056W (VHR1)","+",251969,252026,251833,193,"W-close-F",251833,252026,"chrIX"
"chrIX","YIL057C (RGI2)","-",247801,247622,247865,243,"F-open-W",247622,247865,"chrIX"
"chrIX","YIL058W","+",247845,247865,247622,243,"W-open-F",247622,247865,"chrIX"
"chrIX","YIL059C","-",245984,245778,246188,410,"F-open-W",245778,246188,"chrIX"
"chrIX","YIL060W","+",247041,247217,247008,209,"F-close-W",247008,247217,"chrIX"
"chrIX","YIL061C (SNP1)","-",244628,244443,244727,284,"W-open-W",244443,244727,"chrIX"
"chrIX","YIL062C (ARC15)","-",243885,243745,243967,222,"F-open-W",243745,243967,"chrIX"
"chrIX","YIL063C (YRB2)","-",242720,242705,242879,174,"W-close-F",242705,242879,"chrIX"
"chrIX","YIL064W (SEE1)","+",242794,242879,242705,174,"F-close-W",242705,242879,"chrIX"
"chrIX","YIL065C (FIS1 MDV2)","-",241216,241140,241325,185,"W-close-W",241140,241325,"chrIX"
"chrIX","YIL066C (RNR3 DIN1 RIR3)","-",237951,237765,238035,270,"W-open-W",237765,238035,"chrIX"
"chrIX","YIL067C","-",235641,235482,235725,243,"W-open-W",235482,235725,"chrIX"
"chrIX","YIL068C (SEC6)","-",232960,232967,233154,187,"W-close-W",232967,233154,"chrIX"
"chrIX","YIL069C (RPS24B RPS24EB)","-",231374,231359,231539,180,"W-close-W",231359,231539,"chrIX"
"chrIX","YIL070C (MAM33)","-",230149,229966,230198,232,"F-open-W",229966,230198,"chrIX"
"chrIX","YIL071C (PCI8 CSN11 YIH1 YIL071W)","-",228409,228318,228478,160,"F-close-F",228318,228478,"chrIX"
"chrIX","YIL072W (HOP1)","+",228575,228636,228478,158,"F-close-W",228478,228636,"chrIX"
"chrIX","YIL073C (SPO22 ZIP4)","-",222771,222562,222887,325,"W-open-W",222562,222887,"chrIX"
"chrIX","YIL074C (SER33)","-",221008,220977,221173,196,"W-close-F",220977,221173,"chrIX"
"chrIX","YIL075C (RPN2 SEN3)","-",217759,217699,217909,210,"F-close-W",217699,217909,"chrIX"
"chrIX","YIL076W (SEC28 ANU2)","+",217661,217699,217525,174,"W-close-W",217525,217699,"chrIX"
"chrIX","YIL077C","-",214858,214644,214966,322,"F-open-W",214644,214966,"chrIX"
"chrIX","YIL078W (THS1)","+",214776,214966,214644,322,"W-open-F",214644,214966,"chrIX"
"chrIX","YIL079C (AIR1)","-",210820,210690,210868,178,"W-close-F",210690,210868,"chrIX"
"chrIX","YIL083C (CAB2)","-",203460,203268,203490,222,"F-open-W",203268,203490,"chrIX"
"chrIX","YIL084C (SDS3)","-",202164,202042,202323,281,"W-open-W",202042,202323,"chrIX"
"chrIX","YIL085C (KTR7)","-",200471,200322,200495,173,"W-close-W",200322,200495,"chrIX"
"chrIX","YIL086C","-",199602,199584,199724,140,"F-close-F",199584,199724,"chrIX"
"chrIX","YIL087C (AIM19 LRC2)","-",199554,199393,199584,191,"F-close-W",199393,199584,"chrIX"
"chrIX","YIL088C (AVT7)","-",197841,197609,197898,289,"W-open-F",197609,197898,"chrIX"
"chrIX","YIL089W","+",196652,NA,NA,NA,"+1_missing",196612,196976,"chrIX"
"chrIX","YIL090W (ICE2)","+",195397,195389,195223,166,"F-close-F",195223,195389,"chrIX"
"chrIX","YIL091C (UTP25)","-",190970,190859,191102,243,"F-open-F",190859,191102,"chrIX"
"chrIX","YIL092W","+",191064,191102,190859,243,"F-open-F",190859,191102,"chrIX"
"chrIX","YIL093C (RSM25)","-",187872,187686,187969,283,"W-open-W",187686,187969,"chrIX"
"chrIX","YIL094C (LYS12 LYS10 LYS11)","-",186421,186385,186517,132,"F-close-F",186385,186517,"chrIX"
"chrIX","YIL095W (PRK1 PAK1)","+",186439,186517,186385,132,"F-close-F",186385,186517,"chrIX"
"chrIX","YIL096C","-",182020,181945,182116,171,"W-close-W",181945,182116,"chrIX"
"chrIX","YIL097W (FYV10 GID9)","+",182098,182116,181945,171,"W-close-W",181945,182116,"chrIX"
"chrIX","YIL098C (FMC1)","-",179678,179543,179726,183,"F-close-W",179543,179726,"chrIX"
"chrIX","YIL099W (SGA1)","+",179777,179881,179726,155,"F-close-W",179726,179881,"chrIX"
"chrIX","YIL101C (XBP1)","-",175209,175067,175363,296,"W-open-F",175067,175363,"chrIX"
"chrIX","YIL102C-A","-",172992,172905,173097,192,"W-close-F",172905,173097,"chrIX"
"chrIX","YIL103W (DPH1 KIF48)","+",173101,173097,172905,192,"F-close-W",172905,173097,"chrIX"
"chrIX","YIL104C (SHQ1)","-",169884,169758,170027,269,"W-open-W",169758,170027,"chrIX"
"chrIX","YIL105C (SLM1 LIT2)","-",167495,167421,167663,242,"F-open-F",167421,167663,"chrIX"
"chrIX","YIL106W (MOB1)","+",167533,167663,167421,242,"F-open-F",167421,167663,"chrIX"
"chrIX","YIL107C (PFK26)","-",163269,163137,163347,210,"F-close-F",163137,163347,"chrIX"
"chrIX","YIL108W","+",163060,163137,162902,235,"F-open-F",162902,163137,"chrIX"
"chrIX","YIL109C (SEC24 ANU1)","-",157270,157179,157481,302,"F-open-F",157179,157481,"chrIX"
"chrIX","YIL110W (HPM1 MNI1)","+",157327,157481,157179,302,"F-open-F",157179,157481,"chrIX"
"chrIX","YIL111W (COX5B)","+",155881,156064,155797,267,"F-open-W",155797,156064,"chrIX"
"chrIX","YIL112W (HOS4)","+",154976,155207,154883,324,"W-open-W",154883,155207,"chrIX"
"chrIX","YIL113W (SDP1)","+",151294,151345,151181,164,"W-close-W",151181,151345,"chrIX"
"chrIX","YIL114C (POR2 YVDAC2)","-",149034,148860,149149,289,"W-open-W",148860,149149,"chrIX"
"chrIX","YIL115C (NUP159 NUP158 RAT7)","-",144270,144240,144418,178,"F-close-F",144240,144418,"chrIX"
"chrIX","YIL115W-A","+",144752,144747,144576,171,"F-close-F",144576,144747,"chrIX"
"chrIX","YIL116W (HIS5)","+",144112,144240,144008,232,"F-open-F",144008,144240,"chrIX"
"chrIX","YIL117C (PRM5)","-",140495,140356,140707,351,"W-open-W",140356,140707,"chrIX"
"chrIX","YIL118W (RHO3)","+",140594,140707,140356,351,"W-open-W",140356,140707,"chrIX"
"chrIX","YIL119C (RPI1)","-",136358,136358,136555,197,"F-close-W",136358,136555,"chrIX"
"chrIX","YIL120W (QDR1)","+",136227,136358,136133,225,"F-open-W",136133,136358,"chrIX"
"chrIX","YIL121W (QDR2)","+",134042,134082,133966,116,"F-overlap-F",133966,134082,"chrIX"
"chrIX","YIL122W (POG1)","+",131817,NA,NA,NA,"+1_missing",131778,132148,"chrIX"
"chrIX","YIL123W (SIM1)","+",129907,NA,NA,NA,"+1_missing",129819,130379,"chrIX"
"chrIX","YIL124W (AYR1)","+",127210,127205,127015,190,"W-close-W",127015,127205,"chrIX"
"chrIX","YIL125W (KGD1 OGD1)","+",125936,125919,125747,172,"W-close-F",125747,125919,"chrIX"
"chrIX","YIL126W (STH1 NPS1)","+",122205,122445,122176,269,"F-open-W",122176,122445,"chrIX"
"chrIX","YIL127C (RRT14)","-",116925,116791,116948,157,"W-close-F",116791,116948,"chrIX"
"chrIX","YIL128W (MET18 MMS19)","+",117035,117147,116948,199,"W-close-W",116948,117147,"chrIX"
"chrIX","YIL129C (TAO3 PAG1)","-",105970,105793,106066,273,"F-open-F",105793,106066,"chrIX"
"chrIX","YIL130W (ASG1)","+",105790,105793,105624,169,"F-close-F",105624,105793,"chrIX"
"chrIX","YIL131C (FKH1)","-",100637,100479,100657,178,"W-close-W",100479,100657,"chrIX"
"chrIX","YIL132C (CSM2)","-",99447,99288,99470,182,"W-close-W",99288,99470,"chrIX"
"chrIX","YIL133C (RPL16A RPL13)","-",98433,98424,98602,178,"W-close-F",98424,98602,"chrIX"
"chrIX","YIL134W (FLX1)","+",98397,98424,98248,176,"W-close-F",98248,98424,"chrIX"
"chrIX","YIL135C (VHS2)","-",94910,94908,95084,176,"W-close-F",94908,95084,"chrIX"
"chrIX","YIL136W (OM45)","+",94899,94908,94757,151,"F-close-F",94757,94908,"chrIX"
"chrIX","YIL137C (TMA108 RBF108 TAE3)","-",89866,89691,89963,272,"W-open-W",89691,89963,"chrIX"
"chrIX","YIL138C (TPM2)","-",88885,88669,88908,239,"W-open-F",88669,88908,"chrIX"
"chrIX","YIL139C (REV7)","-",87870,87823,88002,179,"W-close-W",87823,88002,"chrIX"
"chrIX","YIL140W (AXL2 BUD10 SRO4)","+",87961,88002,87823,179,"W-close-W",87823,88002,"chrIX"
"chrIX","YIL142W (CCT2 BIN3 TCP2)","+",84937,85123,84851,272,"W-open-W",84851,85123,"chrIX"
"chrIX","YIL143C (SSL2 LOM3 RAD25)","-",80250,80239,80447,208,"W-close-F",80239,80447,"chrIX"
"chrIX","YIL144W (TID3 HEC1 NDC80)","+",80234,80239,80165,74,"F-overlap-F",80165,80239,"chrIX"
"chrIX","YIL145C (PAN6)","-",76028,75916,76104,188,"W-close-W",75916,76104,"chrIX"
"chrIX","YIL146C (ATG32 ECM37)","-",73969,73849,74069,220,"W-open-F",73849,74069,"chrIX"
"chrIX","YIL147C (SLN1 YPD2)","-",69513,69395,69535,140,"F-close-F",69395,69535,"chrIX"
"chrIX","YIL148W (RPL40A CEP52A UB11 UBI1)","+",69599,69836,69535,301,"F-open-F",69535,69836,"chrIX"
"chrIX","YIL149C (MLP2)","-",62931,62740,63000,260,"W-open-W",62740,63000,"chrIX"
"chrIX","YIL150C (MCM10 DNA43)","-",60764,60626,60801,175,"W-close-W",60626,60801,"chrIX"
"chrIX","YIL151C","-",57295,57117,57483,366,"F-open-W",57117,57483,"chrIX"
"chrIX","YIL152W","+",57376,57483,57117,366,"W-open-F",57117,57483,"chrIX"
"chrIX","YIL153W (RRD1 YPA1)","+",56434,56590,56379,211,"W-close-W",56379,56590,"chrIX"
"chrIX","YIL154C (IMP2' IMP2)","-",53903,53721,54000,279,"W-open-W",53721,54000,"chrIX"
"chrIX","YIL155C (GUT2)","-",51419,51366,51482,116,"F-overlap-F",51366,51482,"chrIX"
"chrIX","YIL156W (UBP7)","+",51511,51585,51482,103,"F-overlap-F",51482,51585,"chrIX"
"chrIX","YIL156W-A","+",48054,48121,47914,207,"W-close-W",47914,48121,"chrIX"
"chrIX","YIL156W-B","+",48066,48121,47914,207,"W-close-W",47914,48121,"chrIX"
"chrIX","YIL157C (COA1 FMP35)","-",46776,46686,46846,160,"F-close-W",46686,46846,"chrIX"
"chrIX","YIL158W (AIM20)","+",46900,47019,46846,173,"F-close-W",46846,47019,"chrIX"
"chrIX","YIL159W (BNR1)","+",46022,46202,45890,312,"W-open-W",45890,46202,"chrIX"
"chrIX","YIL160C (POT1 FOX3 POX3)","-",40086,39977,40311,334,"W-open-W",39977,40311,"chrIX"
"chrIX","YIL161W","+",40179,40311,39977,334,"W-open-W",39977,40311,"chrIX"
"chrIX","YIL162W (SUC2)","+",39203,39188,39074,114,"F-overlap-W",39074,39188,"chrIX"
"chrIX","YIL163C","-",35576,35561,35687,126,"W-close-F",35561,35687,"chrIX"
"chrIX","YIL164C (NIT1)","-",33524,33396,33579,183,"W-close-W",33396,33579,"chrIX"
"chrIX","YIL166C","-",30483,30449,30615,166,"F-close-F",30449,30615,"chrIX"
"chrIX","YIL169C (HPF1')","-",22843,22820,NA,NA,"-1_missing",22820,23528,"chrIX"
"chrIX","YIR001C (SGN1 RBP1 RBP29)","-",355814,355701,355926,225,"F-open-W",355701,355926,"chrIX"
"chrIX","YIR002C (MPH1)","-",357298,357166,357386,220,"F-open-W",357166,357386,"chrIX"
"chrIX","YIR003W (AIM21)","+",362994,363229,362956,273,"W-open-W",362956,363229,"chrIX"
"chrIX","YIR004W (DJP1 ICS1 PAS22)","+",364635,364706,364500,206,"F-close-W",364500,364706,"chrIX"
"chrIX","YIR005W (IST3 SNU17)","+",365411,365481,365280,201,"W-close-F",365280,365481,"chrIX"
"chrIX","YIR006C (PAN1 DIM2 MDP3 MIP3)","-",365379,365280,365481,201,"F-close-W",365280,365481,"chrIX"
"chrIX","YIR007W","+",373106,373137,372955,182,"W-close-W",372955,373137,"chrIX"
"chrIX","YIR008C (PRI1)","-",372992,372955,373137,182,"W-close-W",372955,373137,"chrIX"
"chrIX","YIR009W (MSL1 YIB9 YIB9w)","+",375304,375414,375144,270,"W-open-W",375144,375414,"chrIX"
"chrIX","YIR010W (DSN1)","+",377268,377259,377094,165,"F-close-F",377094,377259,"chrIX"
"chrIX","YIR011C (STS1 DBF8 SSM5)","-",377188,377094,377259,165,"F-close-F",377094,377259,"chrIX"
"chrIX","YIR012W (SQT1)","+",379854,379960,379620,340,"F-open-F",379620,379960,"chrIX"
"chrIX","YIR013C (GAT4)","-",379932,NA,NA,NA,"+1_missing",379620,379960,"chrIX"
"chrIX","YIR014W","+",381826,381972,381723,249,"W-open-W",381723,381972,"chrIX"
"chrIX","YIR016W","+",383501,383538,383307,231,"F-open-F",383307,383538,"chrIX"
"chrIX","YIR017C (MET28)","-",383347,383307,383538,231,"F-open-F",383307,383538,"chrIX"
"chrIX","YIR017W-A","+",384467,384448,NA,NA,"-1_missing",384133,384448,"chrIX"
"chrIX","YIR018W (YAP5)","+",385805,385890,385763,127,"W-close-F",385763,385890,"chrIX"
"chrIX","YIR019C (MUC1 FLO11 STA4)","-",389369,389335,389419,84,"F-overlap-F",389335,389419,"chrIX"
"chrIX","YIR020C","-",393679,393594,393782,188,"F-close-W",393594,393782,"chrIX"
"chrIX","YIR021W (MRS1 PET157)","+",398445,398510,398334,176,"W-close-W",398334,398510,"chrIX"
"chrIX","YIR021W-A","+",399274,399385,399221,164,"W-close-W",399221,399385,"chrIX"
"chrIX","YIR022W (SEC11)","+",399341,399385,399221,164,"W-close-W",399221,399385,"chrIX"
"chrIX","YIR023W (DAL81 UGA35)","+",402758,402793,402565,228,"F-open-F",402565,402793,"chrIX"
"chrIX","YIR024C (GIF1)","-",402772,402565,402793,228,"F-open-F",402565,402793,"chrIX"
"chrIX","YIR025W (MND2)","+",404892,404992,404812,180,"F-close-F",404812,404992,"chrIX"
"chrIX","YIR026C (YVH1)","-",404777,404708,404812,104,"F-overlap-W",404708,404812,"chrIX"
"chrIX","YIR027C (DAL1)","-",406148,405945,406206,261,"F-open-W",405945,406206,"chrIX"
"chrIX","YIR029W (DAL2 ALC1)","+",411882,412104,411842,262,"W-open-W",411842,412104,"chrIX"
"chrIX","YIR030C (DCG1)","-",411982,411842,412104,262,"W-open-W",411842,412104,"chrIX"
"chrIX","YIR031C (DAL7 MLS2 MSL2)","-",412955,412930,413126,196,"W-close-W",412930,413126,"chrIX"
"chrIX","YIR032C (DAL3)","-",414942,414782,415067,285,"W-open-W",414782,415067,"chrIX"
"chrIX","YIR033W (MGA2)","+",419529,419619,419416,203,"F-close-F",419416,419619,"chrIX"
"chrIX","YIR034C (LYS1)","-",419545,419416,419619,203,"F-close-F",419416,419619,"chrIX"
"chrIX","YIR035C","-",420949,420767,421044,277,"W-open-W",420767,421044,"chrIX"
"chrIX","YIR036C (IRC24)","-",422006,421959,422136,177,"W-close-F",421959,422136,"chrIX"
"chrIX","YIR037W (HYR1 GPX3 ORP1)","+",423762,423749,423611,138,"W-close-F",423611,423749,"chrIX"
"chrIX","YIR038C (GTT1)","-",423680,423611,423749,138,"F-close-W",423611,423749,"chrIX"
"chrIX","YIR039C (YPS6)","-",430347,430232,430397,165,"F-close-W",430232,430397,"chrIX"
"chrIX","YIR042C","-",435073,435043,435152,109,"F-overlap-F",435043,435152,"chrIX"
"chrM","Q0080 (ATP8 AAP1)","+",28106,28147,27967,180,"F-close-W",27967,28147,"chrM"
"chrM","Q0085 (ATP6 OLI2 OLI4 PHO1)","+",29494,29528,29355,173,"F-close-W",29355,29528,"chrM"
"chrM","Q0130 (OLI1 ATP9 OLI3)","+",47014,47023,46880,143,"W-close-W",46880,47023,"chrM"
"chrM","Q0275 (COX3 OXI2)","+",80087,80215,79961,254,"W-open-W",79961,80215,"chrM"
"chrV","YEL001C (IRC22)","-",150206,150025,150316,291,"W-open-W",150025,150316,"chrV"
"chrV","YEL002C (WBP1)","-",148633,148529,148875,346,"W-open-W",148529,148875,"chrV"
"chrV","YEL003W (GIM4 PFD2)","+",148723,148875,148529,346,"W-open-W",148529,148875,"chrV"
"chrV","YEL004W (YEA4)","+",148091,148208,147943,265,"W-open-W",147943,148208,"chrV"
"chrV","YEL005C (VAB2 VAB31)","-",145829,145796,145971,175,"W-close-W",145796,145971,"chrV"
"chrV","YEL006W (YEA6 NDT2)","+",145704,145796,145546,250,"W-open-W",145546,145796,"chrV"
"chrV","YEL007W (TOS9)","+",144054,144314,143999,315,"W-open-W",143999,144314,"chrV"
"chrV","YEL008C-A","-",140310,140255,140366,111,"W-overlap-F",140255,140366,"chrV"
"chrV","YEL008W","+",141261,141444,NA,NA,"-1_missing",140889,141444,"chrV"
"chrV","YEL009C (GCN4 AAS101 AAS3 ARG9)","-",138823,NA,NA,NA,"+1_missing",138497,138877,"chrV"
"chrV","YEL011W (GLC3 GHA1)","+",135340,NA,NA,NA,"+1_missing",135310,135651,"chrV"
"chrV","YEL012W (UBC8 GID3)","+",132660,132728,132500,228,"F-open-W",132500,132728,"chrV"
"chrV","YEL013W (VAC8 YEB3)","+",131010,131268,130972,296,"W-open-W",130972,131268,"chrV"
"chrV","YEL015W (EDC3 DCP3 LSM16)","+",128382,128626,128306,320,"W-open-W",128306,128626,"chrV"
"chrV","YEL016C (NPP2)","-",124645,124565,124788,223,"F-open-W",124565,124788,"chrV"
"chrV","YEL017C-A (PMP2)","-",122331,122298,122517,219,"F-open-F",122298,122517,"chrV"
"chrV","YEL017W (GTT3)","+",124761,124788,124565,223,"W-open-F",124565,124788,"chrV"
"chrV","YEL018C-A","-",121417,121248,121503,255,"W-open-F",121248,121503,"chrV"
"chrV","YEL018W (EAF5)","+",122418,122517,122298,219,"F-open-F",122298,122517,"chrV"
"chrV","YEL020C-B","-",117082,116918,117214,296,"W-open-W",116918,117214,"chrV"
"chrV","YEL020W-A (TIM9)","+",117576,117606,117390,216,"W-open-W",117390,117606,"chrV"
"chrV","YEL021W (URA3)","+",117037,117214,116918,296,"W-open-W",116918,117214,"chrV"
"chrV","YEL022W (GEA2)","+",115874,115872,115698,174,"W-close-W",115698,115872,"chrV"
"chrV","YEL023C","-",108383,108363,108547,184,"F-close-W",108363,108547,"chrV"
"chrV","YEL024W (RIP1)","+",108314,108363,108223,140,"F-close-W",108223,108363,"chrV"
"chrV","YEL025C (SRI1)","-",102317,102201,102356,155,"F-close-W",102201,102356,"chrV"
"chrV","YEL026W (SNU13)","+",102402,102512,102356,156,"F-close-W",102356,102512,"chrV"
"chrV","YEL027W (VMA3 CLS7 CUP5 GEF2)","+",101504,101525,101350,175,"F-close-W",101350,101525,"chrV"
"chrV","YEL028W","+",99749,99876,99705,171,"W-close-F",99705,99876,"chrV"
"chrV","YEL029C (BUD16)","-",96741,96716,96898,182,"F-close-W",96716,96898,"chrV"
"chrV","YEL030W (ECM10 SSC3)","+",96730,96716,96497,219,"F-open-W",96497,96716,"chrV"
"chrV","YEL031W (SPF1 COD1 PER9 PIO1)","+",94007,94253,93979,274,"F-open-W",93979,94253,"chrV"
"chrV","YEL032W (MCM3)","+",90034,90262,89963,299,"F-open-W",89963,90262,"chrV"
"chrV","YEL034C-A","-",85515,NA,NA,NA,"+1_missing",85112,85644,"chrV"
"chrV","YEL034W (HYP2 TIF51A eIF-5A eIF5A)","+",86176,NA,NA,NA,"+1_missing",86130,86651,"chrV"
"chrV","YEL036C (ANP1 GEM3 MNN8)","-",82966,82724,83026,302,"W-open-W",82724,83026,"chrV"
"chrV","YEL037C (RAD23)","-",81251,81116,81308,192,"F-close-W",81116,81308,"chrV"
"chrV","YEL038W (UTR4)","+",81202,81308,81116,192,"W-close-F",81116,81308,"chrV"
"chrV","YEL039C (CYC7)","-",79525,79440,79660,220,"F-open-W",79440,79660,"chrV"
"chrV","YEL040W (UTR2 CRH2)","+",79594,79660,79440,220,"W-open-F",79440,79660,"chrV"
"chrV","YEL041W (YEF1)","+",77794,77976,77653,323,"F-open-W",77653,77976,"chrV"
"chrV","YEL042W (GDA1)","+",75471,75581,75392,189,"W-close-W",75392,75581,"chrV"
"chrV","YEL043W","+",73443,73657,73329,328,"W-open-W",73329,73657,"chrV"
"chrV","YEL044W (IES6)","+",70356,70473,70190,283,"W-open-W",70190,70473,"chrV"
"chrV","YEL046C (GLY1)","-",67043,66788,67087,299,"F-open-W",66788,67087,"chrV"
"chrV","YEL047C (FRDS1)","-",65332,65143,65434,291,"W-open-W",65143,65434,"chrV"
"chrV","YEL048C (TCA17)","-",64138,64072,64279,207,"F-close-W",64072,64279,"chrV"
"chrV","YEL049W (PAU2)","+",64232,64279,64072,207,"W-close-F",64072,64279,"chrV"
"chrV","YEL050C (RML2)","-",59504,59260,59576,316,"W-open-W",59260,59576,"chrV"
"chrV","YEL051W (VMA8)","+",59275,59260,59078,182,"W-close-W",59078,59260,"chrV"
"chrV","YEL052W (AFG1)","+",58166,58389,58099,290,"F-open-W",58099,58389,"chrV"
"chrV","YEL053C (MAK10 NAA35)","-",53818,53606,53868,262,"W-open-W",53606,53868,"chrV"
"chrV","YEL053W-A","+",53358,53606,53258,348,"W-open-W",53258,53606,"chrV"
"chrV","YEL054C (RPL12A)","-",52598,52578,52749,171,"W-close-W",52578,52749,"chrV"
"chrV","YEL055C (POL5)","-",48399,48381,48466,85,"F-overlap-F",48381,48466,"chrV"
"chrV","YEL056W (HAT2)","+",48483,48466,48381,85,"F-overlap-F",48381,48466,"chrV"
"chrV","YEL057C","-",44914,44821,44960,139,"W-close-F",44821,44960,"chrV"
"chrV","YEL058W (PCM1 AGM1)","+",45021,45050,44960,90,"W-overlap-F",44960,45050,"chrV"
"chrV","YEL059C-A (SOM1)","-",42336,42062,42468,406,"W-open-F",42062,42468,"chrV"
"chrV","YEL059W (HHY1 ENV6)","+",43235,43285,43022,263,"W-open-W",43022,43285,"chrV"
"chrV","YEL060C (PRB1 CVT1)","-",39815,39631,39898,267,"F-open-W",39631,39898,"chrV"
"chrV","YEL061C (CIN8 KSL2 SDS15)","-",36373,36390,36610,220,"F-open-W",36390,36610,"chrV"
"chrV","YEL062W (NPR2)","+",36393,36390,36217,173,"W-close-W",36217,36390,"chrV"
"chrV","YEL063C (CAN1)","-",31403,31229,31494,265,"F-open-W",31229,31494,"chrV"
"chrV","YEL064C (AVT2)","-",29517,29521,29696,175,"W-close-W",29521,29696,"chrV"
"chrV","YEL065W (SIT1 ARN3)","+",29618,29696,29521,175,"W-close-W",29521,29696,"chrV"
"chrV","YEL066W (HPA3)","+",27283,27461,27224,237,"W-open-W",27224,27461,"chrV"
"chrV","YEL068C","-",25409,25414,25593,179,"W-close-W",25414,25593,"chrV"
"chrV","YEL070W (DSF1)","+",21229,21441,21206,235,"F-open-W",21206,21441,"chrV"
"chrV","YEL071W (DLD3)","+",17951,17934,17726,208,"W-close-F",17726,17934,"chrV"
"chrV","YEL072W (RMD6)","+",14673,14855,14606,249,"F-open-W",14606,14855,"chrV"
"chrV","YEL073C","-",6526,NA,NA,NA,"+1_missing",4063,6549,"chrV"
"chrV","YER001W (MNN1)","+",155918,155967,155805,162,"W-close-W",155805,155967,"chrV"
"chrV","YER002W (NOP16)","+",157592,157630,157462,168,"W-close-F",157462,157630,"chrV"
"chrV","YER003C (PMI40 PMI)","-",157583,157462,157630,168,"F-close-W",157462,157630,"chrV"
"chrV","YER004W (FMP52)","+",160536,160678,160514,164,"F-close-W",160514,160678,"chrV"
"chrV","YER005W (YND1 YEJ5)","+",162553,162579,162492,87,"F-overlap-F",162492,162579,"chrV"
"chrV","YER006W (NUG1)","+",164365,164365,164198,167,"W-close-F",164198,164365,"chrV"
"chrV","YER007C-A (TMA20 RBF20)","-",166105,166058,166188,130,"F-close-F",166058,166188,"chrV"
"chrV","YER007W (PAC2)","+",166182,166188,166058,130,"F-close-F",166058,166188,"chrV"
"chrV","YER008C (SEC3 PSL1)","-",167703,167567,167863,296,"W-open-W",167567,167863,"chrV"
"chrV","YER009W (NTF2)","+",172666,172795,172630,165,"W-close-W",172630,172795,"chrV"
"chrV","YER010C","-",172533,172442,172630,188,"W-close-W",172442,172630,"chrV"
"chrV","YER011W (TIR1 SRP1)","+",176155,176240,176025,215,"F-close-F",176025,176240,"chrV"
"chrV","YER012W (PRE1)","+",178569,178574,178395,179,"F-close-W",178395,178574,"chrV"
"chrV","YER013W (PRP22)","+",182357,182350,182176,174,"W-close-W",182176,182350,"chrV"
"chrV","YER014W (HEM14)","+",184334,184515,184228,287,"W-open-W",184228,184515,"chrV"
"chrV","YER015W (FAA2 FAM1)","+",187028,187037,186964,73,"F-overlap-W",186964,187037,"chrV"
"chrV","YER016W (BIM1 EB1 YEB1)","+",189437,189539,189270,269,"W-open-F",189270,189539,"chrV"
"chrV","YER017C (AFG3 YTA10)","-",189340,189270,189539,269,"F-open-W",189270,189539,"chrV"
"chrV","YER018C (SPC25)","-",191860,191830,NA,NA,"-1_missing",191830,192339,"chrV"
"chrV","YER019C-A (SBH2 SEB2)","-",194212,194153,194392,239,"W-open-F",194153,194392,"chrV"
"chrV","YER019W (ISC1)","+",194311,194392,194153,239,"F-open-W",194153,194392,"chrV"
"chrV","YER020W (GPA2 SSP101)","+",196688,196941,196664,277,"W-open-W",196664,196941,"chrV"
"chrV","YER021W (RPN3 SUN2)","+",198645,198826,198615,211,"F-close-W",198615,198826,"chrV"
"chrV","YER022W (SRB4 MED17)","+",200974,201104,200836,268,"W-open-W",200836,201104,"chrV"
"chrV","YER023C-A","-",201410,201410,201571,161,"W-close-W",201410,201571,"chrV"
"chrV","YER023W (PRO3 ORE2)","+",202005,202170,201878,292,"W-open-W",201878,202170,"chrV"
"chrV","YER024W (YAT2)","+",205082,205262,204960,302,"W-open-W",204960,205262,"chrV"
"chrV","YER025W (GCD11 SUI4)","+",207092,207200,207039,161,"F-close-W",207039,207200,"chrV"
"chrV","YER026C (CHO1 PSS1)","-",207515,207528,207717,189,"F-close-W",207528,207717,"chrV"
"chrV","YER027C (GAL83 SPM1)","-",208766,208773,208965,192,"W-close-W",208773,208965,"chrV"
"chrV","YER028C (MIG3)","-",210636,210535,210706,171,"W-close-W",210535,210706,"chrV"
"chrV","YER029C (SMB1)","-",212494,212365,212588,223,"W-open-F",212365,212588,"chrV"
"chrV","YER030W (CHZ1)","+",214029,214091,213956,135,"F-close-F",213956,214091,"chrV"
"chrV","YER031C (YPT31 YPT8)","-",213919,213825,213956,131,"F-close-W",213825,213956,"chrV"
"chrV","YER032W (FIR1 PIP1)","+",217955,217964,217754,210,"F-close-F",217754,217964,"chrV"
"chrV","YER033C (ZRG8)","-",217866,217754,217964,210,"F-close-F",217754,217964,"chrV"
"chrV","YER034W","+",222599,222658,NA,NA,"-1_missing",222176,222658,"chrV"
"chrV","YER035W (EDC2)","+",223248,223234,223005,229,"W-open-F",223005,223234,"chrV"
"chrV","YER036C (ARB1)","-",223260,223234,223430,196,"F-close-F",223234,223430,"chrV"
"chrV","YER037W (PHM8)","+",227074,227098,227024,74,"F-overlap-F",227024,227098,"chrV"
"chrV","YER038C (KRE29 NSE6)","-",226104,225998,226189,191,"W-close-W",225998,226189,"chrV"
"chrV","YER038W-A","+",229356,229467,229296,171,"W-close-W",229296,229467,"chrV"
"chrV","YER039C (HVG1 YEM9)","-",228271,228218,228445,227,"W-open-W",228218,228445,"chrV"
"chrV","YER040W (GLN3)","+",232249,232438,232227,211,"F-close-W",232227,232438,"chrV"
"chrV","YER041W (YEN1)","+",234908,234912,234651,261,"W-open-W",234651,234912,"chrV"
"chrV","YER042W (MXR1 MSRA)","+",235621,235767,235553,214,"F-close-F",235553,235767,"chrV"
"chrV","YER043C (SAH1)","-",235535,235553,235767,214,"F-close-F",235553,235767,"chrV"
"chrV","YER044C (ERG28 BUD18)","-",237445,237163,237474,311,"W-open-W",237163,237474,"chrV"
"chrV","YER044C-A (MEI4)","-",238022,237916,238095,179,"W-close-W",237916,238095,"chrV"
"chrV","YER045C (ACA1)","-",239910,239759,239962,203,"F-close-W",239759,239962,"chrV"
"chrV","YER046W (SPO73)","+",243665,243793,243531,262,"F-open-F",243531,243793,"chrV"
"chrV","YER047C (SAP1)","-",243723,243531,243793,262,"F-open-F",243531,243793,"chrV"
"chrV","YER048C (CAJ1)","-",246861,246640,246909,269,"W-open-F",246640,246909,"chrV"
"chrV","YER048W-A (ISD11)","+",251336,251392,251213,179,"W-close-W",251213,251392,"chrV"
"chrV","YER049W (TPA1)","+",253754,253905,253707,198,"F-close-F",253707,253905,"chrV"
"chrV","YER050C (RSM18)","-",253847,253707,253905,198,"F-close-F",253707,253905,"chrV"
"chrV","YER051W (JHD1)","+",256237,256431,256169,262,"F-open-W",256169,256431,"chrV"
"chrV","YER052C (HOM3 BOR1 SIL4)","-",256263,256169,256431,262,"W-open-F",256169,256431,"chrV"
"chrV","YER053C (PIC2)","-",258594,258573,258774,201,"W-close-F",258573,258774,"chrV"
"chrV","YER053C-A","-",260564,260479,260650,171,"W-close-W",260479,260650,"chrV"
"chrV","YER054C (GIP2)","-",261870,261832,262010,178,"W-close-F",261832,262010,"chrV"
"chrV","YER055C (HIS1)","-",264809,264815,264902,87,"F-overlap-F",264815,264902,"chrV"
"chrV","YER056C (FCY2 BRA7)","-",266391,266357,266505,148,"F-close-F",266357,266505,"chrV"
"chrV","YER056C-A (RPL34A)","-",269337,269258,269476,218,"F-open-W",269258,269476,"chrV"
"chrV","YER057C (HMF1 HIG1)","-",270636,NA,NA,NA,"+1_missing",270161,270674,"chrV"
"chrV","YER058W (PET117)","+",272216,272232,272057,175,"W-close-F",272057,272232,"chrV"
"chrV","YER059W (PCL6)","+",273988,274040,273809,231,"F-open-F",273809,274040,"chrV"
"chrV","YER060W (FCY21)","+",276250,276287,276215,72,"F-overlap-F",276215,276287,"chrV"
"chrV","YER061C (CEM1)","-",278236,278097,278285,188,"F-close-F",278097,278285,"chrV"
"chrV","YER062C (HOR2 GPP2)","-",279755,279712,279869,157,"F-close-F",279712,279869,"chrV"
"chrV","YER063W (THO1)","+",282519,282537,282468,69,"F-overlap-F",282468,282537,"chrV"
"chrV","YER064C","-",282449,282468,282537,69,"F-overlap-F",282468,282537,"chrV"
"chrV","YER065C (ICL1)","-",285119,285035,285179,144,"F-close-F",285035,285179,"chrV"
"chrV","YER066C-A","-",291585,291534,291807,273,"W-open-W",291534,291807,"chrV"
"chrV","YER066W (RRT13)","+",290943,291023,290838,185,"W-close-W",290838,291023,"chrV"
"chrV","YER067C-A","-",291985,291983,292153,170,"W-close-W",291983,292153,"chrV"
"chrV","YER067W (RGI1)","+",292641,292683,292505,178,"W-close-W",292505,292683,"chrV"
"chrV","YER068W (MOT2 NOT4 SIG1)","+",294911,294978,294784,194,"W-close-W",294784,294978,"chrV"
"chrV","YER069W (ARG5%2C6)","+",298128,298217,298039,178,"W-close-W",298039,298217,"chrV"
"chrV","YER070W (RNR1 CRT7 RIR1 SDS12)","+",301822,301911,301617,294,"W-open-F",301617,301911,"chrV"
"chrV","YER071C","-",301724,301617,301911,294,"F-open-W",301617,301911,"chrV"
"chrV","YER072W (VTC1 NRF1 PHM4)","+",303341,303402,303282,120,"F-close-F",303282,303402,"chrV"
"chrV","YER073W (ALD5)","+",305768,NA,NA,NA,"+1_missing",305617,306344,"chrV"
"chrV","YER074W (RPS24A RPS24EA)","+",307315,307400,307175,225,"W-open-W",307175,307400,"chrV"
"chrV","YER074W-A (YOS1)","+",308301,308431,308146,285,"W-open-F",308146,308431,"chrV"
"chrV","YER075C (PTP3)","-",308285,308146,308431,285,"F-open-W",308146,308431,"chrV"
"chrV","YER076C","-",312305,312288,312463,175,"W-close-F",312288,312463,"chrV"
"chrV","YER077C","-",314469,314342,314595,253,"F-open-F",314342,314595,"chrV"
"chrV","YER078C (ICP55)","-",316723,316724,316796,72,"F-overlap-F",316724,316796,"chrV"
"chrV","YER079W","+",319805,319970,319723,247,"F-open-W",319723,319970,"chrV"
"chrV","YER080W (AIM9 FMP29)","+",321945,322227,321881,346,"W-open-W",321881,322227,"chrV"
"chrV","YER081W (SER3)","+",324278,324311,324136,175,"F-close-F",324136,324311,"chrV"
"chrV","YER082C (UTP7 KRE31)","-",324180,324136,324311,175,"F-close-F",324136,324311,"chrV"
"chrV","YER083C (GET2 HUR2 RMD7)","-",326130,325937,326249,312,"W-open-W",325937,326249,"chrV"
"chrV","YER084W","+",327557,327614,327434,180,"W-close-W",327434,327614,"chrV"
"chrV","YER085C","-",327492,327434,327614,180,"W-close-W",327434,327614,"chrV"
"chrV","YER086W (ILV1 ISO1)","+",330346,330334,330169,165,"W-close-W",330169,330334,"chrV"
"chrV","YER087C-B (SBH1 SEB1 YER087C-A)","-",332374,332322,332490,168,"W-close-W",332322,332490,"chrV"
"chrV","YER087W (AIM10)","+",332451,332490,332322,168,"W-close-W",332322,332490,"chrV"
"chrV","YER088C (DOT6 PBF2)","-",333036,332824,333124,300,"F-open-W",332824,333124,"chrV"
"chrV","YER088C-A","-",335267,335169,335335,166,"F-close-W",335169,335335,"chrV"
"chrV","YER088W-B","+",337670,337922,337608,314,"W-open-W",337608,337922,"chrV"
"chrV","YER089C (PTC2)","-",335891,335893,336068,175,"F-close-F",335893,336068,"chrV"
"chrV","YER090W (TRP2)","+",339576,339599,339524,75,"F-overlap-F",339524,339599,"chrV"
"chrV","YER091C (MET6)","-",339639,339599,339671,72,"F-overlap-F",339599,339671,"chrV"
"chrV","YER092W (IES5)","+",343447,343498,343204,294,"W-open-W",343204,343498,"chrV"
"chrV","YER093C (TSC11 AVO3)","-",343262,343204,343498,294,"W-open-W",343204,343498,"chrV"
"chrV","YER093C-A (AIM11 GEP8)","-",347782,347632,347888,256,"W-open-W",347632,347888,"chrV"
"chrV","YER094C (PUP3 SCS32)","-",348575,348390,348608,218,"W-open-W",348390,348608,"chrV"
"chrV","YER095W (RAD51 MUT5)","+",351417,351590,351304,286,"W-open-W",351304,351590,"chrV"
"chrV","YER096W (SHC1)","+",353422,353504,353333,171,"F-close-W",353333,353504,"chrV"
"chrV","YER098W (UBP9)","+",358153,358213,358012,201,"F-close-W",358012,358213,"chrV"
"chrV","YER099C (PRS2)","-",358031,358012,358213,201,"W-close-F",358012,358213,"chrV"
"chrV","YER100W (UBC6 DOA2)","+",360406,360513,360334,179,"F-close-W",360334,360513,"chrV"
"chrV","YER101C (AST2)","-",360382,360334,360513,179,"W-close-F",360334,360513,"chrV"
"chrV","YER102W (RPS8B)","+",363837,363888,363704,184,"F-close-F",363704,363888,"chrV"
"chrV","YER103W (SSA4 YG107)","+",366645,366828,366594,234,"F-open-W",366594,366828,"chrV"
"chrV","YER104W (RTT105)","+",367808,367882,367683,199,"W-close-W",367683,367882,"chrV"
"chrV","YER105C (NUP157)","-",367714,367683,367882,199,"W-close-W",367683,367882,"chrV"
"chrV","YER106W (MAM1)","+",373434,373561,373395,166,"F-close-W",373395,373561,"chrV"
"chrV","YER107C (GLE2 RAE1)","-",373331,373295,373395,100,"F-overlap-F",373295,373395,"chrV"
"chrV","YER109C (FLO8 PHD5 YER108C)","-",374960,374955,375104,149,"W-close-W",374955,375104,"chrV"
"chrV","YER110C (KAP123 YRB4)","-",378610,378604,378801,197,"W-close-F",378604,378801,"chrV"
"chrV","YER111C (SWI4 ART1)","-",382452,382197,382491,294,"W-open-W",382197,382491,"chrV"
"chrV","YER112W (LSM4 SDB23 USS1)","+",387888,387913,387837,76,"W-overlap-F",387837,387913,"chrV"
"chrV","YER113C (TMN3)","-",387786,387701,387837,136,"W-close-W",387701,387837,"chrV"
"chrV","YER114C (BOI2 BEB1)","-",390352,390161,390403,242,"W-open-W",390161,390403,"chrV"
"chrV","YER115C (SPR6)","-",394191,393969,394281,312,"W-open-W",393969,394281,"chrV"
"chrV","YER116C (SLX8)","-",394982,394879,395054,175,"W-close-W",394879,395054,"chrV"
"chrV","YER117W (RPL23B)","+",397747,397748,397574,174,"W-close-F",397574,397748,"chrV"
"chrV","YER118C (SHO1 SSU81)","-",397773,397748,397951,203,"F-close-F",397748,397951,"chrV"
"chrV","YER119C (AVT6)","-",399398,399187,399435,248,"W-open-W",399187,399435,"chrV"
"chrV","YER120W (SCS2)","+",401971,401956,401883,73,"F-overlap-F",401883,401956,"chrV"
"chrV","YER121W","+",402835,402963,402681,282,"F-open-F",402681,402963,"chrV"
"chrV","YER122C (GLO3)","-",402728,402681,402963,282,"F-open-F",402681,402963,"chrV"
"chrV","YER123W (YCK3 CKI3)","+",406766,406763,406578,185,"F-close-W",406578,406763,"chrV"
"chrV","YER124C (DSE1)","-",407001,406998,407202,204,"W-close-W",406998,407202,"chrV"
"chrV","YER125W (RSP5 MDP1 MUT2 NPI1 SMM1 UBY1)","+",413011,413090,412867,223,"F-open-W",412867,413090,"chrV"
"chrV","YER126C (NSA2)","-",413237,413224,413312,88,"F-overlap-F",413224,413312,"chrV"
"chrV","YER127W (LCP5)","+",415673,415661,415483,178,"W-close-W",415483,415661,"chrV"
"chrV","YER128W","+",416611,416789,416515,274,"W-open-W",416515,416789,"chrV"
"chrV","YER129W (SAK1 PAK1)","+",420979,420968,420747,221,"F-open-F",420747,420968,"chrV"
"chrV","YER130C","-",420900,420747,420968,221,"F-open-F",420747,420968,"chrV"
"chrV","YER131W (RPS26B)","+",424454,424711,424409,302,"F-open-F",424409,424711,"chrV"
"chrV","YER132C (PMD1)","-",425055,425067,425160,93,"F-overlap-F",425067,425160,"chrV"
"chrV","YER133W (GLC7 CID1 DIS2 DIS2S1 PP1)","+",434379,434460,434210,250,"F-open-F",434210,434460,"chrV"
"chrV","YER134C","-",437010,436951,437156,205,"F-close-F",436951,437156,"chrV"
"chrV","YER136W (GDI1 SEC19)","+",441295,441348,441164,184,"F-close-W",441164,441348,"chrV"
"chrV","YER137C","-",441212,441164,441348,184,"W-close-F",441164,441348,"chrV"
"chrV","YER139C (RTR1)","-",449856,449789,449973,184,"W-close-W",449789,449973,"chrV"
"chrV","YER140W","+",453455,453584,453422,162,"W-close-W",453422,453584,"chrV"
"chrV","YER141W (COX15)","+",455158,455218,455018,200,"F-close-W",455018,455218,"chrV"
"chrV","YER142C (MAG1 MMS5)","-",455059,455018,455218,200,"W-close-F",455018,455218,"chrV"
"chrV","YER143W (DDI1 VSM1)","+",457755,457749,457633,116,"F-overlap-F",457633,457749,"chrV"
"chrV","YER144C (UBP5)","-",457689,457633,457749,116,"F-overlap-F",457633,457749,"chrV"
"chrV","YER145C (FTR1)","-",460413,460362,460476,114,"F-overlap-F",460362,460476,"chrV"
"chrV","YER146W (LSM5)","+",462951,463051,462890,161,"F-close-F",462890,463051,"chrV"
"chrV","YER147C (SCC4)","-",462891,462890,463051,161,"F-close-F",462890,463051,"chrV"
"chrV","YER147C-A","-",465112,464861,465152,291,"W-open-W",464861,465152,"chrV"
"chrV","YER148W (SPT15 BTF1 TBP1)","+",466042,466149,465955,194,"F-close-F",465955,466149,"chrV"
"chrV","YER149C (PEA2 DFG9 PPF2)","-",466130,466149,466291,142,"W-close-F",466149,466291,"chrV"
"chrV","YER150W (SPI1)","+",468981,468966,468801,165,"F-close-F",468801,468966,"chrV"
"chrV","YER151C (UBP3 BLM3)","-",469611,469531,469631,100,"W-overlap-F",469531,469631,"chrV"
"chrV","YER152C","-",472605,472460,472746,286,"W-open-W",472460,472746,"chrV"
"chrV","YER154W (OXA1 PET1402)","+",476293,476346,476231,115,"F-overlap-W",476231,476346,"chrV"
"chrV","YER155C (BEM2 IPL2 SUP9 TSL1)","-",476193,476162,476231,69,"F-overlap-F",476162,476231,"chrV"
"chrV","YER156C","-",483218,483067,483353,286,"W-open-W",483067,483353,"chrV"
"chrV","YER157W (COG3 GRD20 SEC34)","+",487251,NA,NA,NA,"+1_missing",487147,487571,"chrV"
"chrV","YER158C","-",488730,488507,488799,292,"W-open-W",488507,488799,"chrV"
"chrV","YER158W-A","+",491998,491991,491872,119,"W-overlap-F",491872,491991,"chrV"
"chrV","YER159C (BUR6 NCB1)","-",491400,NA,NA,NA,"+1_missing",490942,491499,"chrV"
"chrV","YER161C (SPT2 EXA1 SIN1)","-",499076,499032,499234,202,"W-close-W",499032,499234,"chrV"
"chrV","YER162C (RAD4)","-",500520,500342,500642,300,"W-open-W",500342,500642,"chrV"
"chrV","YER163C","-",502982,502874,503139,265,"W-open-W",502874,503139,"chrV"
"chrV","YER164W (CHD1)","+",509926,NA,NA,NA,"+1_missing",509869,510226,"chrV"
"chrV","YER165W (PAB1)","+",512239,512513,512207,306,"W-open-W",512207,512513,"chrV"
"chrV","YER166W (DNF1)","+",517578,517576,517363,213,"W-close-W",517363,517576,"chrV"
"chrV","YER167W (BCK2 CTR7)","+",520781,520809,520636,173,"F-close-F",520636,520809,"chrV"
"chrV","YER168C (CCA1 TNT1)","-",520958,520809,521026,217,"F-open-F",520809,521026,"chrV"
"chrV","YER169W (RPH1)","+",525960,526006,525700,306,"W-open-F",525700,526006,"chrV"
"chrV","YER170W (ADK2 AKY3 PAK3)","+",526999,526993,526719,274,"W-open-F",526719,526993,"chrV"
"chrV","YER171W (RAD3 REM1)","+",529518,529605,529388,217,"F-open-W",529388,529605,"chrV"
"chrV","YER172C (BRR2 PRP44 RSS1 SLT22 SNU246)","-",529406,529388,529605,217,"W-open-F",529388,529605,"chrV"
"chrV","YER173W (RAD24 RS1)","+",538452,538510,538260,250,"F-open-F",538260,538510,"chrV"
"chrV","YER174C (GRX4)","-",538337,538260,538510,250,"F-open-F",538260,538510,"chrV"
"chrV","YER175C (TMT1 TAM1)","-",539234,539092,539274,182,"W-close-W",539092,539274,"chrV"
"chrV","YER175W-A","+",541606,541704,541401,303,"W-open-W",541401,541704,"chrV"
"chrV","YER176W (ECM32 HEL1 MTT1)","+",545169,NA,NA,NA,"+1_missing",545042,545562,"chrV"
"chrV","YER177W (BMH1 APR6)","+",546549,546817,546516,301,"F-open-W",546516,546817,"chrV"
"chrV","YER178W (PDA1)","+",548213,548361,548172,189,"W-close-W",548172,548361,"chrV"
"chrV","YER179W (DMC1 ISC2)","+",549583,549729,549493,236,"W-open-F",549493,549729,"chrV"
"chrV","YER180C (ISC10)","-",549667,549493,549729,236,"F-open-W",549493,549729,"chrV"
"chrV","YER180C-A (SLO1)","-",550776,550790,550960,170,"W-close-W",550790,550960,"chrV"
"chrV","YER182W (FMP10)","+",553357,553410,553215,195,"W-close-W",553215,553410,"chrV"
"chrV","YER183C (FAU1)","-",553242,553215,553410,195,"W-close-W",553215,553410,"chrV"
"chrV","YER184C","-",555951,555895,556026,131,"F-close-F",555895,556026,"chrV"
"chrV","YER185W (PUG1)","+",560393,560401,560230,171,"W-close-W",560230,560401,"chrV"
"chrV","YER186C","-",561493,561426,561514,88,"F-overlap-F",561426,561514,"chrV"
"chrV","YER187W","+",566820,566858,566685,173,"W-close-W",566685,566858,"chrV"
"chrV","YER188W","+",568989,569073,568889,184,"F-close-F",568889,569073,"chrV"
"chrVI","YFL001W (DEG1 HRM3 PUS3)","+",148491,148576,148382,194,"W-close-W",148382,148576,"chrVI"
"chrVI","YFL002C (SPB4)","-",144981,144840,145028,188,"F-close-F",144840,145028,"chrVI"
"chrVI","YFL004W (VTC2 PHM1)","+",134437,134469,134278,191,"F-close-F",134278,134469,"chrVI"
"chrVI","YFL005W (SEC4 SRO6)","+",131198,131187,131012,175,"W-close-W",131012,131187,"chrVI"
"chrVI","YFL007W (BLM10 YFL006W)","+",129987,130188,129918,270,"W-open-W",129918,130188,"chrVI"
"chrVI","YFL008W (SMC1 CHL10)","+",123209,123393,123086,307,"W-open-W",123086,123393,"chrVI"
"chrVI","YFL009W (CDC4)","+",118569,118566,118397,169,"W-close-F",118397,118566,"chrVI"
"chrVI","YFL010C (WWM1)","-",114946,114913,115116,203,"F-close-W",114913,115116,"chrVI"
"chrVI","YFL010W-A (AUA1 YFL011W-A)","+",115917,116000,115735,265,"W-open-W",115735,116000,"chrVI"
"chrVI","YFL011W (HXT10)","+",114054,114260,113987,273,"W-open-W",113987,114260,"chrVI"
"chrVI","YFL012W","+",111252,111297,111108,189,"F-close-W",111108,111297,"chrVI"
"chrVI","YFL013C (IES1)","-",107710,107562,107809,247,"F-open-W",107562,107809,"chrVI"
"chrVI","YFL014W (HSP12 GLP1 HOR5)","+",107770,107809,107562,247,"W-open-F",107562,107809,"chrVI"
"chrVI","YFL015C","-",106289,106234,NA,NA,"-1_missing",106234,107031,"chrVI"
"chrVI","YFL015W-A","+",106808,107031,NA,NA,"-1_missing",106234,107031,"chrVI"
"chrVI","YFL016C (MDJ1)","-",104598,104434,104671,237,"F-open-W",104434,104671,"chrVI"
"chrVI","YFL017C (GNA1 PAT1)","-",103884,103724,103916,192,"F-close-W",103724,103916,"chrVI"
"chrVI","YFL017W-A (SMX2 SNP2 YFL018W-A)","+",104004,104095,103916,179,"F-close-W",103916,104095,"chrVI"
"chrVI","YFL018C (LPD1 HPD1)","-",101545,NA,NA,NA,"+1_missing",101227,101607,"chrVI"
"chrVI","YFL020C (PAU5)","-",99116,99048,99241,193,"W-close-W",99048,99241,"chrVI"
"chrVI","YFL021C-A","-",95731,95525,95846,321,"W-open-W",95525,95846,"chrVI"
"chrVI","YFL021W (GAT1 MEP80 NIL1)","+",97505,97705,97447,258,"F-open-F",97447,97705,"chrVI"
"chrVI","YFL022C (FRS2)","-",93391,93300,93414,114,"F-overlap-F",93300,93414,"chrVI"
"chrVI","YFL023W (BUD27 URI1)","+",93465,93510,93414,96,"F-overlap-F",93414,93510,"chrVI"
"chrVI","YFL024C (EPL1)","-",87450,87286,87543,257,"W-open-W",87286,87543,"chrVI"
"chrVI","YFL025C (BST1 PER17)","-",83989,83940,84011,71,"F-overlap-F",83940,84011,"chrVI"
"chrVI","YFL026W (STE2)","+",84073,84082,84011,71,"F-overlap-F",84011,84082,"chrVI"
"chrVI","YFL027C (GYP8)","-",80345,80199,80462,263,"F-open-W",80199,80462,"chrVI"
"chrVI","YFL028C (CAF16)","-",79270,79149,79347,198,"W-close-W",79149,79347,"chrVI"
"chrVI","YFL029C (CAK1 CIV1)","-",77992,77897,78137,240,"W-open-F",77897,78137,"chrVI"
"chrVI","YFL030W (AGX1)","+",78076,78137,77897,240,"F-open-W",77897,78137,"chrVI"
"chrVI","YFL031C-A (YFL030C-A)","-",75947,75937,76107,170,"W-close-F",75937,76107,"chrVI"
"chrVI","YFL031W (HAC1 ERN4 IRE15)","+",76561,76604,76409,195,"F-close-F",76409,76604,"chrVI"
"chrVI","YFL033C (RIM15 TAK1)","-",68896,68708,69174,466,"W-open-W",68708,69174,"chrVI"
"chrVI","YFL034C-A (RPL22B YFL035C-B)","-",64173,63990,64243,253,"W-open-W",63990,64243,"chrVI"
"chrVI","YFL034C-B (MOB2 YFL035C YFL035C-A)","-",62843,62704,63015,311,"F-open-F",62704,63015,"chrVI"
"chrVI","YFL034W","+",68815,NA,NA,NA,"+1_missing",68708,69174,"chrVI"
"chrVI","YFL036W (RPO41)","+",62937,63015,62704,311,"F-open-F",62704,63015,"chrVI"
"chrVI","YFL037W (TUB2 ARM10 SHE8)","+",57934,58096,57890,206,"F-close-W",57890,58096,"chrVI"
"chrVI","YFL038C (YPT1 YP2)","-",55260,NA,NA,NA,"+1_missing",54811,55353,"chrVI"
"chrVI","YFL039C (ACT1 ABY1 END7)","-",53111,52925,53139,214,"F-close-W",52925,53139,"chrVI"
"chrVI","YFL040W","+",53370,53404,53313,91,"F-overlap-F",53313,53404,"chrVI"
"chrVI","YFL041W (FET5)","+",51181,51358,51126,232,"F-open-W",51126,51358,"chrVI"
"chrVI","YFL041W-A","+",48970,49146,48950,196,"W-close-W",48950,49146,"chrVI"
"chrVI","YFL042C (YFL043C)","-",45630,45560,45753,193,"W-close-W",45560,45753,"chrVI"
"chrVI","YFL044C (OTU1 YOD1)","-",44444,44298,44481,183,"W-close-W",44298,44481,"chrVI"
"chrVI","YFL045C (SEC53 ALG4)","-",43477,43333,43515,182,"F-close-W",43333,43515,"chrVI"
"chrVI","YFL046W (FMP32)","+",43587,43671,43515,156,"F-close-W",43515,43671,"chrVI"
"chrVI","YFL047W (RGD2)","+",42638,42835,42587,248,"W-open-W",42587,42835,"chrVI"
"chrVI","YFL048C (EMP47)","-",38727,38669,38874,205,"F-close-F",38669,38874,"chrVI"
"chrVI","YFL049W (SWP82)","+",38826,38874,38669,205,"F-close-F",38669,38874,"chrVI"
"chrVI","YFL050C (ALR2)","-",32987,32852,33067,215,"W-close-W",32852,33067,"chrVI"
"chrVI","YFL052W","+",30237,30285,30212,73,"F-overlap-F",30212,30285,"chrVI"
"chrVI","YFL054C","-",20782,20723,20927,204,"W-close-F",20723,20927,"chrVI"
"chrVI","YFL055W (AGP3)","+",19085,19166,18960,206,"W-close-W",18960,19166,"chrVI"
"chrVI","YFL057C (AAD16)","-",14192,14175,14424,249,"W-open-W",14175,14424,"chrVI"
"chrVI","YFR001W (LOC1)","+",149805,150053,149759,294,"W-open-W",149759,150053,"chrVI"
"chrVI","YFR002W (NIC96)","+",152628,152648,152453,195,"W-close-W",152453,152648,"chrVI"
"chrVI","YFR003C (YPI1)","-",152493,152453,152648,195,"W-close-W",152453,152648,"chrVI"
"chrVI","YFR004W (RPN11 MPR1)","+",154403,154384,154233,151,"W-close-F",154233,154384,"chrVI"
"chrVI","YFR005C (SAD1)","-",154312,154233,154384,151,"F-close-W",154233,154384,"chrVI"
"chrVI","YFR006W","+",157841,NA,NA,NA,"+1_missing",157737,158161,"chrVI"
"chrVI","YFR007W (YFH7 AIM12)","+",160426,160541,160310,231,"W-open-W",160310,160541,"chrVI"
"chrVI","YFR008W (FAR7)","+",161547,161561,161393,168,"W-close-F",161393,161561,"chrVI"
"chrVI","YFR009W (GCN20)","+",164812,165027,164766,261,"W-open-W",164766,165027,"chrVI"
"chrVI","YFR010W (UBP6)","+",166663,166764,166619,145,"F-close-W",166619,166764,"chrVI"
"chrVI","YFR010W-A","+",167059,167079,166913,166,"F-close-W",166913,167079,"chrVI"
"chrVI","YFR011C (AIM13)","-",166585,166534,166619,85,"F-overlap-F",166534,166619,"chrVI"
"chrVI","YFR012W","+",168507,168529,168367,162,"W-close-W",168367,168529,"chrVI"
"chrVI","YFR013W (IOC3)","+",172439,172468,172392,76,"F-overlap-F",172392,172468,"chrVI"
"chrVI","YFR014C (CMK1)","-",172323,172259,172392,133,"F-close-W",172259,172392,"chrVI"
"chrVI","YFR015C (GSY1)","-",174126,173892,174202,310,"W-open-W",173892,174202,"chrVI"
"chrVI","YFR016C","-",176998,177008,177182,174,"W-close-W",177008,177182,"chrVI"
"chrVI","YFR017C","-",182165,182011,182248,237,"W-open-W",182011,182248,"chrVI"
"chrVI","YFR018C","-",182969,182909,182996,87,"F-overlap-W",182909,182996,"chrVI"
"chrVI","YFR019W (FAB1 SVL7)","+",191394,191395,191226,169,"W-close-W",191226,191395,"chrVI"
"chrVI","YFR020W","+",193769,193820,193666,154,"W-close-F",193666,193820,"chrVI"
"chrVI","YFR021W (ATG18 AUT10 CVT18 NMR1 SVP1)","+",196421,196600,196348,252,"W-open-W",196348,196600,"chrVI"
"chrVI","YFR022W (ROG3 ART7)","+",199146,199169,198991,178,"W-close-W",198991,199169,"chrVI"
"chrVI","YFR023W (PES4)","+",201816,201863,201679,184,"W-close-F",201679,201863,"chrVI"
"chrVI","YFR024C-A (LSB3 YFR024C)","-",201761,201679,201863,184,"F-close-W",201679,201863,"chrVI"
"chrVI","YFR025C (HIS2)","-",203639,203650,203825,175,"W-close-W",203650,203825,"chrVI"
"chrVI","YFR026C (ULI1)","-",205674,205598,205749,151,"F-close-F",205598,205749,"chrVI"
"chrVI","YFR027W (ECO1 CTF7)","+",208430,208499,208277,222,"W-open-W",208277,208499,"chrVI"
"chrVI","YFR028C (CDC14 OAF3)","-",208337,208277,208499,222,"W-open-W",208277,208499,"chrVI"
"chrVI","YFR029W (PTR3 SSY3)","+",213045,213256,212935,321,"W-open-W",212935,213256,"chrVI"
"chrVI","YFR030W (MET10)","+",216476,216655,216387,268,"F-open-W",216387,216655,"chrVI"
"chrVI","YFR031C (SMC2)","-",216536,216387,216655,268,"W-open-F",216387,216655,"chrVI"
"chrVI","YFR031C-A (RPL2A RPL5B)","-",220401,220322,220523,201,"W-close-W",220322,220523,"chrVI"
"chrVI","YFR032C (RRT5)","-",221988,NA,NA,NA,"+1_missing",221567,222108,"chrVI"
"chrVI","YFR032C-A (RPL29)","-",223162,222959,223248,289,"F-open-W",222959,223248,"chrVI"
"chrVI","YFR032C-B","-",223162,222959,223248,289,"F-open-W",222959,223248,"chrVI"
"chrVI","YFR033C (QCR6 COR3 UCR6)","-",224185,NA,NA,NA,"+1_missing",223778,224261,"chrVI"
"chrVI","YFR034C (PHO4 phoD)","-",224805,224815,NA,NA,"-1_missing",224815,225439,"chrVI"
"chrVI","YFR034W-A","+",226632,NA,NA,NA,"+1_missing",226456,226962,"chrVI"
"chrVI","YFR036W (CDC26 HIT3 SCD26)","+",227467,227647,227413,234,"F-open-F",227413,227647,"chrVI"
"chrVI","YFR037C (RSC8 SWH3)","-",227395,227413,227647,234,"F-open-F",227413,227647,"chrVI"
"chrVI","YFR038W (IRC5)","+",232029,232086,231882,204,"W-close-W",231882,232086,"chrVI"
"chrVI","YFR039C","-",231945,231882,232086,204,"W-close-W",231882,232086,"chrVI"
"chrVI","YFR040W (SAP155)","+",237341,237385,237143,242,"F-open-W",237143,237385,"chrVI"
"chrVI","YFR041C (ERJ5)","-",237245,237143,237385,242,"W-open-F",237143,237385,"chrVI"
"chrVI","YFR042W (KEG1)","+",239152,239301,239124,177,"W-close-W",239124,239301,"chrVI"
"chrVI","YFR043C (IRC6)","-",239059,238957,239124,167,"W-close-W",238957,239124,"chrVI"
"chrVI","YFR044C (DUG1)","-",239923,239634,240049,415,"F-open-W",239634,240049,"chrVI"
"chrVI","YFR045W","+",243085,243075,242985,90,"F-overlap-F",242985,243075,"chrVI"
"chrVI","YFR046C (CNN1)","-",242989,242985,243075,90,"F-overlap-F",242985,243075,"chrVI"
"chrVI","YFR047C (BNA6 QPT1)","-",244198,244108,244329,221,"W-open-W",244108,244329,"chrVI"
"chrVI","YFR048W (RMD8)","+",248177,248385,248116,269,"F-open-W",248116,248385,"chrVI"
"chrVI","YFR049W (YMR31)","+",249012,249093,248876,217,"W-open-F",248876,249093,"chrVI"
"chrVI","YFR050C (PRE4)","-",248936,248876,249093,217,"F-open-W",248876,249093,"chrVI"
"chrVI","YFR051C (RET2)","-",250090,249866,250161,295,"W-open-W",249866,250161,"chrVI"
"chrVI","YFR052C-A","-",253423,253303,253691,388,"W-open-F",253303,253691,"chrVI"
"chrVI","YFR052W (RPN12 NIN1)","+",253406,253691,253303,388,"F-open-W",253303,253691,"chrVI"
"chrVI","YFR053C (HXK1)","-",253453,253303,253691,388,"W-open-F",253303,253691,"chrVI"
"chrVI","YFR055W (IRC7)","+",265704,265758,265679,79,"F-overlap-W",265679,265758,"chrVI"
"chrVII","YGL001C (ERG26)","-",495307,495304,495378,74,"F-overlap-F",495304,495378,"chrVII"
"chrVII","YGL002W (ERP6)","+",495338,495378,495304,74,"F-overlap-F",495304,495378,"chrVII"
"chrVII","YGL003C (CDH1 HCT1)","-",492323,492171,492346,175,"W-close-W",492171,492346,"chrVII"
"chrVII","YGL004C (RPN14)","-",490658,490526,490780,254,"W-open-W",490526,490780,"chrVII"
"chrVII","YGL005C (COG7 COD5)","-",489493,489436,489646,210,"F-close-W",489436,489646,"chrVII"
"chrVII","YGL006W (PMC1)","+",489558,489646,489436,210,"W-close-F",489436,489646,"chrVII"
"chrVII","YGL006W-A","+",485884,486007,485828,179,"F-close-F",485828,486007,"chrVII"
"chrVII","YGL007C-A","-",482900,482837,483010,173,"F-close-F",482837,483010,"chrVII"
"chrVII","YGL007W (BRP1)","+",483965,484005,NA,NA,"-1_missing",483232,484005,"chrVII"
"chrVII","YGL008C (PMA1 KTI10)","-",479415,479413,479668,255,"F-open-F",479413,479668,"chrVII"
"chrVII","YGL009C (LEU1)","-",476152,476169,476247,78,"F-overlap-F",476169,476247,"chrVII"
"chrVII","YGL010W","+",476261,476247,476169,78,"F-overlap-F",476169,476247,"chrVII"
"chrVII","YGL011C (SCL1 PRC2)","-",474339,474308,474446,138,"F-close-F",474308,474446,"chrVII"
"chrVII","YGL012W (ERG4)","+",474379,474446,474308,138,"F-close-F",474308,474446,"chrVII"
"chrVII","YGL013C (PDR1 AMY1 ANT1 BOR2 CYH3 NRA2 SMR2 TIL1 TPE1 TPE3)","-",468993,468944,469018,74,"F-overlap-F",468944,469018,"chrVII"
"chrVII","YGL014W (PUF4 YGL023)","+",468896,468944,468861,83,"F-overlap-F",468861,468944,"chrVII"
"chrVII","YGL015C","-",464935,464932,465169,237,"W-open-F",464932,465169,"chrVII"
"chrVII","YGL016W (KAP122 PDR6)","+",465080,465169,464932,237,"F-open-W",464932,465169,"chrVII"
"chrVII","YGL017W (ATE1)","+",461442,461649,461387,262,"W-open-W",461387,461649,"chrVII"
"chrVII","YGL018C (JAC1)","-",458974,458947,459158,211,"W-close-W",458947,459158,"chrVII"
"chrVII","YGL019W (CKB1)","+",459096,459158,458947,211,"W-close-W",458947,459158,"chrVII"
"chrVII","YGL020C (GET1 MDM39)","-",457084,457012,457229,217,"W-open-F",457012,457229,"chrVII"
"chrVII","YGL022W (STT3)","+",454642,454821,454531,290,"W-open-W",454531,454821,"chrVII"
"chrVII","YGL023C (PIB2)","-",450069,449933,450194,261,"W-open-W",449933,450194,"chrVII"
"chrVII","YGL025C (PGD1 HRS1 MED3)","-",448679,448524,448802,278,"W-open-W",448524,448802,"chrVII"
"chrVII","YGL026C (TRP5)","-",446330,446338,446449,111,"F-overlap-F",446338,446449,"chrVII"
"chrVII","YGL027C (CWH41 DER7 GLS1)","-",443550,443353,443616,263,"W-open-W",443353,443616,"chrVII"
"chrVII","YGL028C (SCW11)","-",440982,440906,441128,222,"W-open-F",440906,441128,"chrVII"
"chrVII","YGL029W (CGR1)","+",440606,NA,NA,NA,"+1_missing",440556,440906,"chrVII"
"chrVII","YGL030W (RPL30)","+",439744,439787,439613,174,"W-close-W",439613,439787,"chrVII"
"chrVII","YGL031C (RPL24A RPL30A)","-",437363,437254,437445,191,"F-close-W",437254,437445,"chrVII"
"chrVII","YGL032C (AGA2)","-",436470,436406,436604,198,"W-close-W",436406,436604,"chrVII"
"chrVII","YGL033W (HOP2)","+",436540,436604,436406,198,"W-close-W",436406,436604,"chrVII"
"chrVII","YGL035C (MIG1 CAT4 SSN1 TDS22)","-",431395,431226,431588,362,"F-open-F",431226,431588,"chrVII"
"chrVII","YGL036W","+",431343,431588,431226,362,"F-open-F",431226,431588,"chrVII"
"chrVII","YGL037C (PNC1)","-",427156,426944,427239,295,"F-open-W",426944,427239,"chrVII"
"chrVII","YGL038C (OCH1 LDB12 NGD29)","-",425069,424977,425172,195,"F-close-F",424977,425172,"chrVII"
"chrVII","YGL039W","+",425115,425172,424977,195,"F-close-F",424977,425172,"chrVII"
"chrVII","YGL040C (HEM2 OLE4 SLU1)","-",419320,419187,419348,161,"F-close-W",419187,419348,"chrVII"
"chrVII","YGL041C","-",418668,418602,418852,250,"W-open-W",418602,418852,"chrVII"
"chrVII","YGL041C-B","-",418668,418602,418852,250,"W-open-W",418602,418852,"chrVII"
"chrVII","YGL041W-A","+",419430,419489,419348,141,"F-close-F",419348,419489,"chrVII"
"chrVII","YGL043W (DST1 PPR2)","+",418634,418852,418602,250,"W-open-W",418602,418852,"chrVII"
"chrVII","YGL044C (RNA15)","-",415872,415805,415908,103,"W-overlap-F",415805,415908,"chrVII"
"chrVII","YGL045W (RIM8 ART9 PAL3 YGL046W)","+",415948,415995,415908,87,"W-overlap-F",415908,415995,"chrVII"
"chrVII","YGL047W (ALG13)","+",412191,NA,NA,NA,"+1_missing",412160,412510,"chrVII"
"chrVII","YGL048C (RPT6 CIM3 CRL3 SCB68 SUG1)","-",409973,409971,410152,181,"W-close-W",409971,410152,"chrVII"
"chrVII","YGL049C (TIF4632)","-",406693,406687,406769,82,"F-overlap-F",406687,406769,"chrVII"
"chrVII","YGL050W (TYW3)","+",406803,406943,406769,174,"F-close-F",406769,406943,"chrVII"
"chrVII","YGL053W (PRM8)","+",403709,403878,403677,201,"F-close-F",403677,403878,"chrVII"
"chrVII","YGL054C (ERV14)","-",400572,400475,400657,182,"F-close-F",400475,400657,"chrVII"
"chrVII","YGL055W (OLE1 MDM2)","+",400384,400475,NA,NA,"-1_missing",400076,400475,"chrVII"
"chrVII","YGL056C (SDS23)","-",395956,395773,396057,284,"W-open-W",395773,396057,"chrVII"
"chrVII","YGL057C (GEP7)","-",394813,394774,395112,338,"W-open-W",394774,395112,"chrVII"
"chrVII","YGL058W (RAD6 PSO8 UBC2)","+",394724,394774,394614,160,"W-close-W",394614,394774,"chrVII"
"chrVII","YGL059W (PKP2)","+",393757,393982,393663,319,"W-open-W",393663,393982,"chrVII"
"chrVII","YGL060W (YBP2)","+",392079,392237,391963,274,"W-open-W",391963,392237,"chrVII"
"chrVII","YGL061C (DUO1)","-",388865,388680,388938,258,"F-open-W",388680,388938,"chrVII"
"chrVII","YGL062W (PYC1)","+",388792,388938,388680,258,"W-open-F",388680,388938,"chrVII"
"chrVII","YGL063C-A","-",383408,383166,383448,282,"W-open-W",383166,383448,"chrVII"
"chrVII","YGL063W (PUS2)","+",385163,385229,385080,149,"F-close-F",385080,385229,"chrVII"
"chrVII","YGL064C (MRH4)","-",381450,381264,381524,260,"W-open-W",381264,381524,"chrVII"
"chrVII","YGL065C (ALG2)","-",379701,379616,379749,133,"F-close-W",379616,379749,"chrVII"
"chrVII","YGL066W (SGF73 SCA7)","+",379835,379842,379749,93,"F-overlap-F",379749,379842,"chrVII"
"chrVII","YGL067W (NPY1)","+",377293,377468,377189,279,"W-open-W",377189,377468,"chrVII"
"chrVII","YGL068W (MNP1)","+",375847,375840,375656,184,"F-close-W",375656,375840,"chrVII"
"chrVII","YGL069C (SRF3)","-",374905,374815,375095,280,"W-open-W",374815,375095,"chrVII"
"chrVII","YGL070C (RPB9 SHI SSU73)","-",374139,374151,374360,209,"W-close-F",374151,374360,"chrVII"
"chrVII","YGL071W (AFT1 RCS1)","+",374221,374360,374151,209,"F-close-W",374151,374360,"chrVII"
"chrVII","YGL072C","-",370610,370583,370683,100,"W-overlap-F",370583,370683,"chrVII"
"chrVII","YGL073W (HSF1 EXA3 MAS3)","+",371311,371524,371184,340,"W-open-W",371184,371524,"chrVII"
"chrVII","YGL075C (MPS2 MMC1)","-",366591,366564,366634,70,"F-overlap-F",366564,366634,"chrVII"
"chrVII","YGL076C (RPL7A)","-",364226,364052,364362,310,"W-open-W",364052,364362,"chrVII"
"chrVII","YGL077C (HNM1 CTR1)","-",362141,362148,362306,158,"W-close-W",362148,362306,"chrVII"
"chrVII","YGL078C (DBP3)","-",360099,359972,360122,150,"F-close-W",359972,360122,"chrVII"
"chrVII","YGL079W (KXD1 KIB1)","+",360215,360287,360122,165,"F-close-F",360122,360287,"chrVII"
"chrVII","YGL080W (FMP37)","+",359289,359467,359251,216,"F-open-W",359251,359467,"chrVII"
"chrVII","YGL081W","+",358628,358773,358565,208,"F-close-W",358565,358773,"chrVII"
"chrVII","YGL082W","+",357131,357331,357085,246,"F-open-W",357085,357331,"chrVII"
"chrVII","YGL083W (SCY1)","+",355612,355797,355519,278,"W-open-W",355519,355797,"chrVII"
"chrVII","YGL084C (GUP1)","-",350504,350490,350570,80,"F-overlap-F",350490,350570,"chrVII"
"chrVII","YGL085W (LCL3)","+",350613,350685,350570,115,"F-overlap-F",350570,350685,"chrVII"
"chrVII","YGL086W (MAD1)","+",349450,349624,349386,238,"F-open-W",349386,349624,"chrVII"
"chrVII","YGL087C (MMS2)","-",346282,346175,346392,217,"W-open-W",346175,346392,"chrVII"
"chrVII","YGL088W","+",346417,346565,346392,173,"W-close-W",346392,346565,"chrVII"
"chrVII","YGL090W (LIF1)","+",345259,345370,345209,161,"W-close-W",345209,345370,"chrVII"
"chrVII","YGL091C (NBP35)","-",341910,341864,341944,80,"F-overlap-F",341864,341944,"chrVII"
"chrVII","YGL092W (NUP145 RAT10)","+",341915,341944,341864,80,"F-overlap-F",341864,341944,"chrVII"
"chrVII","YGL093W (SPC105)","+",337677,337845,337583,262,"W-open-W",337583,337845,"chrVII"
"chrVII","YGL094C (PAN2)","-",330971,330922,331104,182,"W-close-W",330922,331104,"chrVII"
"chrVII","YGL095C (VPS45 STT10 VPL28)","-",328782,328631,328802,171,"W-close-F",328631,328802,"chrVII"
"chrVII","YGL096W (TOS8)","+",326359,326362,326164,198,"W-close-F",326164,326362,"chrVII"
"chrVII","YGL097W (SRM1 MTR1 PRP20)","+",323333,323474,323283,191,"F-close-W",323283,323474,"chrVII"
"chrVII","YGL098W (USE1 SLT1)","+",318595,318603,318425,178,"W-close-F",318425,318603,"chrVII"
"chrVII","YGL099W (LSG1 KRE35)","+",316603,316836,316562,274,"F-open-W",316562,316836,"chrVII"
"chrVII","YGL100W (SEH1)","+",314371,314382,314190,192,"W-close-F",314190,314382,"chrVII"
"chrVII","YGL101W","+",313080,313229,313004,225,"W-open-W",313004,313229,"chrVII"
"chrVII","YGL102C","-",310954,310951,311117,166,"W-close-W",310951,311117,"chrVII"
"chrVII","YGL103W (RPL28 CYH2)","+",312008,312215,311977,238,"W-open-W",311977,312215,"chrVII"
"chrVII","YGL104C (VPS73)","-",308576,308424,308630,206,"F-close-F",308424,308630,"chrVII"
"chrVII","YGL105W (ARC1)","+",308670,308720,308630,90,"F-overlap-F",308630,308720,"chrVII"
"chrVII","YGL106W (MLC1)","+",307141,307422,307111,311,"F-open-W",307111,307422,"chrVII"
"chrVII","YGL107C (RMD9)","-",304218,304061,304338,277,"W-open-W",304061,304338,"chrVII"
"chrVII","YGL108C","-",303479,303380,303666,286,"F-open-W",303380,303666,"chrVII"
"chrVII","YGL110C (CUE3)","-",301441,301457,301574,117,"F-overlap-F",301457,301574,"chrVII"
"chrVII","YGL111W (NSA1)","+",301538,301574,301457,117,"F-overlap-F",301457,301574,"chrVII"
"chrVII","YGL112C (TAF6 TAF60)","-",298048,298004,298074,70,"F-overlap-F",298004,298074,"chrVII"
"chrVII","YGL113W (SLD3)","+",298186,298266,298074,192,"F-close-W",298074,298266,"chrVII"
"chrVII","YGL114W","+",295704,295924,295656,268,"W-open-W",295656,295924,"chrVII"
"chrVII","YGL115W (SNF4 CAT3 SCI1)","+",293090,293268,293018,250,"W-open-W",293018,293268,"chrVII"
"chrVII","YGL116W (CDC20 PAC5)","+",291739,291955,291684,271,"W-open-W",291684,291955,"chrVII"
"chrVII","YGL117W","+",289403,289612,289362,250,"W-open-F",289362,289612,"chrVII"
"chrVII","YGL119W (COQ8 ABC1)","+",286054,286160,285896,264,"W-open-W",285896,286160,"chrVII"
"chrVII","YGL120C (PRP43 JA1)","-",281541,281535,281736,201,"W-close-W",281535,281736,"chrVII"
"chrVII","YGL121C (GPG1)","-",280631,280646,280820,174,"W-close-F",280646,280820,"chrVII"
"chrVII","YGL122C (NAB2)","-",278712,278711,278928,217,"W-open-F",278711,278928,"chrVII"
"chrVII","YGL123C-A","-",277329,277042,277481,439,"W-open-W",277042,277481,"chrVII"
"chrVII","YGL123W (RPS2 RPS4 SUP138 SUP38 SUP44)","+",278470,278530,278344,186,"W-close-F",278344,278530,"chrVII"
"chrVII","YGL124C (MON1 AUT12)","-",274656,274615,274809,194,"F-close-F",274615,274809,"chrVII"
"chrVII","YGL125W (MET13 MET11 MRPL45)","+",274682,274809,274615,194,"F-close-F",274615,274809,"chrVII"
"chrVII","YGL126W (SCS3 FIT2B)","+",272381,272444,272332,112,"F-overlap-F",272332,272444,"chrVII"
"chrVII","YGL127C (SOH1 MED31)","-",270245,270108,270290,182,"F-close-W",270108,270290,"chrVII"
"chrVII","YGL128C (CWC23)","-",269114,269080,269358,278,"W-open-W",269080,269358,"chrVII"
"chrVII","YGL129C (RSM23)","-",267574,267450,267618,168,"F-close-W",267450,267618,"chrVII"
"chrVII","YGL130W (CEG1)","+",267671,267782,267618,164,"F-close-F",267618,267782,"chrVII"
"chrVII","YGL131C (SNT2)","-",260277,260196,260333,137,"F-close-F",260196,260333,"chrVII"
"chrVII","YGL133W (ITC1)","+",261572,261572,261436,136,"F-close-F",261436,261572,"chrVII"
"chrVII","YGL134W (PCL10)","+",257033,257065,256885,180,"W-close-W",256885,257065,"chrVII"
"chrVII","YGL135W (RPL1B SSM2)","+",255391,255433,255282,151,"W-close-F",255282,255433,"chrVII"
"chrVII","YGL136C (MRM2)","-",252771,252743,252825,82,"F-overlap-F",252743,252825,"chrVII"
"chrVII","YGL137W (SEC27)","+",252884,252917,252825,92,"F-overlap-F",252825,252917,"chrVII"
"chrVII","YGL139W (FLC3 HUF3)","+",248436,248500,248242,258,"F-open-F",248242,248500,"chrVII"
"chrVII","YGL140C","-",241079,240943,241123,180,"F-close-W",240943,241123,"chrVII"
"chrVII","YGL141W (HUL5)","+",241202,241234,241123,111,"F-overlap-F",241123,241234,"chrVII"
"chrVII","YGL142C (GPI10)","-",236150,236112,236317,205,"W-close-W",236112,236317,"chrVII"
"chrVII","YGL143C (MRF1)","-",234605,234507,234763,256,"W-open-W",234507,234763,"chrVII"
"chrVII","YGL144C (ROG1)","-",232377,232258,232442,184,"F-close-F",232258,232442,"chrVII"
"chrVII","YGL145W (TIP20 TIP1)","+",232459,232442,232258,184,"F-close-F",232258,232442,"chrVII"
"chrVII","YGL146C (RRT6)","-",228488,228415,NA,NA,"-1_missing",228415,228808,"chrVII"
"chrVII","YGL147C (RPL9A)","-",227646,227576,227858,282,"W-open-F",227576,227858,"chrVII"
"chrVII","YGL148W (ARO2)","+",227628,227858,227576,282,"F-open-W",227576,227858,"chrVII"
"chrVII","YGL150C (INO80)","-",220919,220891,220964,73,"F-overlap-F",220891,220964,"chrVII"
"chrVII","YGL151W (NUT1 MED5)","+",221013,221139,220964,175,"F-close-F",220964,221139,"chrVII"
"chrVII","YGL153W (PEX14)","+",217345,217528,217267,261,"W-open-W",217267,217528,"chrVII"
"chrVII","YGL154C (LYS5)","-",215210,215175,215373,198,"W-close-F",215175,215373,"chrVII"
"chrVII","YGL155W (CDC43 CAL1)","+",215592,215707,215528,179,"W-close-W",215528,215707,"chrVII"
"chrVII","YGL156W (AMS1)","+",213815,214013,213729,284,"F-open-W",213729,214013,"chrVII"
"chrVII","YGL157W (ARI1)","+",210141,210348,210092,256,"W-open-F",210092,210348,"chrVII"
"chrVII","YGL158W (RCK1)","+",208696,208967,208596,371,"F-open-W",208596,208967,"chrVII"
"chrVII","YGL159W","+",204023,204096,203851,245,"F-open-W",203851,204096,"chrVII"
"chrVII","YGL160W (AIM14)","+",202407,202481,202291,190,"W-close-W",202291,202481,"chrVII"
"chrVII","YGL161C (YIP5)","-",199064,198976,199097,121,"F-close-F",198976,199097,"chrVII"
"chrVII","YGL162W (SUT1)","+",199173,199249,199097,152,"F-close-F",199097,199249,"chrVII"
"chrVII","YGL163C (RAD54 XRS1)","-",193572,193536,193713,177,"W-close-W",193536,193713,"chrVII"
"chrVII","YGL164C (YRB30)","-",191914,191753,192019,266,"W-open-W",191753,192019,"chrVII"
"chrVII","YGL166W (CUP2 ACE1)","+",191958,192019,191753,266,"W-open-W",191753,192019,"chrVII"
"chrVII","YGL167C (PMR1 BSD1 LDB1 SSC1)","-",187440,187343,187513,170,"F-close-W",187343,187513,"chrVII"
"chrVII","YGL169W (SUA5)","+",187377,187513,187343,170,"W-close-F",187343,187513,"chrVII"
"chrVII","YGL171W (ROK1)","+",184174,184224,184037,187,"F-close-W",184037,184224,"chrVII"
"chrVII","YGL172W (NUP49 NSP49)","+",182217,182402,182127,275,"F-open-W",182127,182402,"chrVII"
"chrVII","YGL173C (KEM1 DST2 RAR5 SEP1 SKI1 XRN1)","-",175347,175273,175457,184,"W-close-W",175273,175457,"chrVII"
"chrVII","YGL174W (BUD13 CWC26)","+",175512,175606,175457,149,"W-close-F",175457,175606,"chrVII"
"chrVII","YGL176C","-",171312,171270,171443,173,"W-close-F",171270,171443,"chrVII"
"chrVII","YGL178W (MPT5 HTR1 PUF5 UTH4)","+",171233,171270,171065,205,"F-close-F",171065,171270,"chrVII"
"chrVII","YGL179C (TOS3)","-",163350,163136,163403,267,"W-open-F",163136,163403,"chrVII"
"chrVII","YGL180W (ATG1 APG1 AUT3 CVT10)","+",163108,163136,162958,178,"W-close-F",162958,163136,"chrVII"
"chrVII","YGL181W (GTS1 FHT1 LSR1)","+",159204,159223,159010,213,"W-close-W",159010,159223,"chrVII"
"chrVII","YGL184C (STR3)","-",154504,154458,154542,84,"F-overlap-F",154458,154542,"chrVII"
"chrVII","YGL185C","-",153087,153051,153234,183,"W-close-W",153051,153234,"chrVII"
"chrVII","YGL186C (TPN1)","-",150995,150888,151101,213,"W-close-W",150888,151101,"chrVII"
"chrVII","YGL187C (COX4)","-",149613,149617,149788,171,"W-close-W",149617,149788,"chrVII"
"chrVII","YGL188C-A","-",148186,147905,148260,355,"F-open-W",147905,148260,"chrVII"
"chrVII","YGL189C (RPS26A RPS26)","-",148160,147905,148260,355,"F-open-W",147905,148260,"chrVII"
"chrVII","YGL190C (CDC55)","-",145595,145538,145738,200,"F-close-F",145538,145738,"chrVII"
"chrVII","YGL191W (COX13)","+",145434,145431,NA,NA,"-1_missing",145087,145431,"chrVII"
"chrVII","YGL192W (IME4 SPO8)","+",144087,144087,143922,165,"W-close-W",143922,144087,"chrVII"
"chrVII","YGL193C","-",141865,141730,141990,260,"W-open-W",141730,141990,"chrVII"
"chrVII","YGL194C (HOS2 RTL1)","-",140245,140172,140430,258,"W-open-W",140172,140430,"chrVII"
"chrVII","YGL194C-A","-",139577,139467,139632,165,"F-close-W",139467,139632,"chrVII"
"chrVII","YGL195W (GCN1 AAS103 NDR1)","+",139652,139811,139632,179,"F-close-W",139632,139811,"chrVII"
"chrVII","YGL196W (DSD1)","+",131279,131546,131247,299,"W-open-W",131247,131546,"chrVII"
"chrVII","YGL197W (MDS3)","+",129652,129820,129535,285,"W-open-W",129535,129820,"chrVII"
"chrVII","YGL198W (YIP4)","+",124347,124526,124214,312,"W-open-W",124214,124526,"chrVII"
"chrVII","YGL199C","-",123538,123296,123633,337,"W-open-W",123296,123633,"chrVII"
"chrVII","YGL200C (EMP24 BST2)","-",122581,122416,122627,211,"W-close-F",122416,122627,"chrVII"
"chrVII","YGL201C (MCM6)","-",117669,117598,117712,114,"F-overlap-F",117598,117712,"chrVII"
"chrVII","YGL202W (ARO8)","+",117659,117712,117598,114,"F-overlap-F",117598,117712,"chrVII"
"chrVII","YGL203C (KEX1)","-",112406,112345,112462,117,"F-overlap-F",112345,112462,"chrVII"
"chrVII","YGL204C","-",111201,111188,NA,NA,"-1_missing",111188,111543,"chrVII"
"chrVII","YGL205W (POX1 FOX1)","+",110588,110630,110505,125,"W-close-F",110505,110630,"chrVII"
"chrVII","YGL206C (CHC1 SWA5)","-",102266,102217,102415,198,"F-close-F",102217,102415,"chrVII"
"chrVII","YGL207W (SPT16 CDC68 SSF1)","+",102205,102217,102074,143,"F-close-F",102074,102217,"chrVII"
"chrVII","YGL208W (SIP2 SPM2)","+",98714,98927,98638,289,"W-open-W",98638,98927,"chrVII"
"chrVII","YGL209W (MIG2 MLZ1)","+",97140,97257,97100,157,"W-close-F",97100,97257,"chrVII"
"chrVII","YGL210W (YPT32)","+",94576,94618,94541,77,"F-overlap-W",94541,94618,"chrVII"
"chrVII","YGL211W (NCS6 TUC1 YGL210W-A)","+",93688,93805,93523,282,"W-open-W",93523,93805,"chrVII"
"chrVII","YGL212W (VAM7 VPL24 VPS43)","+",92464,92557,92297,260,"W-open-W",92297,92557,"chrVII"
"chrVII","YGL213C (SKI8 REC103)","-",89950,89948,90073,125,"W-close-F",89948,90073,"chrVII"
"chrVII","YGL215W (CLG1)","+",89733,89948,NA,NA,"-1_missing",89432,89948,"chrVII"
"chrVII","YGL216W (KIP3)","+",87349,87556,87261,295,"W-open-W",87261,87556,"chrVII"
"chrVII","YGL218W (SRF1)","+",84482,84650,84232,418,"W-open-W",84232,84650,"chrVII"
"chrVII","YGL219C (MDM34 MMM2)","-",82794,82666,82850,184,"W-close-W",82666,82850,"chrVII"
"chrVII","YGL221C (NIF3)","-",81333,81192,81480,288,"W-open-W",81192,81480,"chrVII"
"chrVII","YGL222C (EDC1)","-",80509,80511,80718,207,"W-close-F",80511,80718,"chrVII"
"chrVII","YGL223C (COG1 COD3 LDB11 SEC36)","-",79068,78929,79218,289,"W-open-F",78929,79218,"chrVII"
"chrVII","YGL224C (SDT1 SSM1)","-",77943,77856,78114,258,"W-open-F",77856,78114,"chrVII"
"chrVII","YGL225W (VRG4 GOG5 LDB3 VAN2 VIG4)","+",78032,78114,77856,258,"F-open-W",77856,78114,"chrVII"
"chrVII","YGL226C-A (OST5)","-",72597,72607,72809,202,"W-close-F",72607,72809,"chrVII"
"chrVII","YGL226W (MTC3)","+",73792,73896,73568,328,"W-open-F",73568,73896,"chrVII"
"chrVII","YGL227W (VID30 GID1)","+",72736,72809,72607,202,"F-close-W",72607,72809,"chrVII"
"chrVII","YGL228W (SHE10)","+",69483,69645,69218,427,"W-open-W",69218,69645,"chrVII"
"chrVII","YGL229C (SAP4)","-",64326,64285,64541,256,"W-open-W",64285,64541,"chrVII"
"chrVII","YGL230C","-",63680,63579,63810,231,"W-open-W",63579,63810,"chrVII"
"chrVII","YGL231C (EMC4)","-",62975,62934,63109,175,"W-close-W",62934,63109,"chrVII"
"chrVII","YGL232W (TAN1)","+",63071,63109,62934,175,"W-close-W",62934,63109,"chrVII"
"chrVII","YGL233W (SEC15)","+",61919,62111,61881,230,"W-open-W",61881,62111,"chrVII"
"chrVII","YGL234W (ADE5%2C7)","+",58994,59132,58867,265,"F-open-W",58867,59132,"chrVII"
"chrVII","YGL236C (MTO1 IPS1)","-",53717,53570,53841,271,"W-open-W",53570,53841,"chrVII"
"chrVII","YGL237C (HAP2)","-",52594,52582,52721,139,"W-close-F",52582,52721,"chrVII"
"chrVII","YGL238W (CSE1 KAP109)","+",52532,52582,52423,159,"F-close-F",52423,52582,"chrVII"
"chrVII","YGL240W (DOC1 APC10)","+",49479,49567,49288,279,"W-open-W",49288,49567,"chrVII"
"chrVII","YGL241W (KAP114)","+",48561,48645,48388,257,"W-open-W",48388,48645,"chrVII"
"chrVII","YGL242C","-",44503,44517,44715,198,"W-close-F",44517,44715,"chrVII"
"chrVII","YGL243W (TAD1)","+",44605,44715,44517,198,"F-close-W",44517,44715,"chrVII"
"chrVII","YGL244W (RTF1 CSL3)","+",43266,43408,43104,304,"F-open-W",43104,43408,"chrVII"
"chrVII","YGL245W (GUS1 GSN1)","+",41209,41226,41030,196,"W-close-W",41030,41226,"chrVII"
"chrVII","YGL246C (RAI1)","-",37490,37471,37666,195,"W-close-F",37471,37666,"chrVII"
"chrVII","YGL247W (BRR6)","+",37623,37666,37471,195,"F-close-W",37471,37666,"chrVII"
"chrVII","YGL248W (PDE1)","+",36827,36966,36695,271,"W-open-W",36695,36966,"chrVII"
"chrVII","YGL249W (ZIP2)","+",35549,35564,35496,68,"F-overlap-F",35496,35564,"chrVII"
"chrVII","YGL250W (RMR1)","+",32850,32895,32813,82,"F-overlap-F",32813,32895,"chrVII"
"chrVII","YGL252C (RTG2)","-",25627,25612,25770,158,"W-close-F",25612,25770,"chrVII"
"chrVII","YGL253W (HXK2 HEX1 HKB SCI2)","+",25587,25612,25476,136,"F-close-F",25476,25612,"chrVII"
"chrVII","YGL254W (FZF1 NRC299 RSU1 SUL1)","+",23868,23910,23715,195,"W-close-F",23715,23910,"chrVII"
"chrVII","YGL255W (ZRT1)","+",22204,22335,22093,242,"F-open-W",22093,22335,"chrVII"
"chrVII","YGL256W (ADH4 NRC465 ZRG5)","+",16490,16550,16368,182,"F-close-W",16368,16550,"chrVII"
"chrVII","YGL257C (MNT2)","-",12359,12340,12409,69,"F-overlap-F",12340,12409,"chrVII"
"chrVII","YGL258W (VEL1)","+",11986,12074,11847,227,"W-open-F",11847,12074,"chrVII"
"chrVII","YGL258W-A","+",9950,10028,9869,159,"W-close-W",9869,10028,"chrVII"
"chrVII","YGL263W (COS12)","+",4011,4105,3894,211,"F-close-F",3894,4105,"chrVII"
"chrVII","YGR001C","-",497056,496962,497171,209,"W-close-W",496962,497171,"chrVII"
"chrVII","YGR002C (SWC4 EAF2 GOD1)","-",498215,498005,498241,236,"W-open-W",498005,498241,"chrVII"
"chrVII","YGR003W (CUL3 CULB)","+",502600,502668,502501,167,"F-close-W",502501,502668,"chrVII"
"chrVII","YGR004W (PEX31)","+",504580,504722,504497,225,"F-open-W",504497,504722,"chrVII"
"chrVII","YGR005C (TFG2)","-",504542,504497,504722,225,"W-open-F",504497,504722,"chrVII"
"chrVII","YGR006W (PRP18)","+",506951,506998,506719,279,"W-open-W",506719,506998,"chrVII"
"chrVII","YGR007W (ECT1 MUQ1)","+",508079,508061,507993,68,"F-overlap-F",507993,508061,"chrVII"
"chrVII","YGR008C (STF2)","-",507950,507806,507993,187,"F-close-W",507806,507993,"chrVII"
"chrVII","YGR009C (SEC9 HSS7)","-",508946,508751,509011,260,"F-open-F",508751,509011,"chrVII"
"chrVII","YGR012W","+",514396,514567,514336,231,"W-open-W",514336,514567,"chrVII"
"chrVII","YGR013W (SNU71)","+",516678,516683,NA,NA,"-1_missing",516296,516683,"chrVII"
"chrVII","YGR014W (MSB2)","+",520990,521001,520834,167,"W-close-W",520834,521001,"chrVII"
"chrVII","YGR015C","-",520894,520834,521001,167,"W-close-W",520834,521001,"chrVII"
"chrVII","YGR016W","+",523271,523388,523238,150,"F-close-W",523238,523388,"chrVII"
"chrVII","YGR017W","+",524794,524989,524692,297,"W-open-W",524692,524989,"chrVII"
"chrVII","YGR018C","-",523758,523661,523845,184,"W-close-W",523661,523845,"chrVII"
"chrVII","YGR019W (UGA1)","+",526736,526902,526628,274,"W-open-W",526628,526902,"chrVII"
"chrVII","YGR020C (VMA7)","-",526816,526628,526902,274,"W-open-W",526628,526902,"chrVII"
"chrVII","YGR021W","+",528588,528884,528485,399,"W-open-W",528485,528884,"chrVII"
"chrVII","YGR023W (MTL1)","+",531190,531294,531094,200,"W-close-W",531094,531294,"chrVII"
"chrVII","YGR024C (THG1)","-",531798,531785,531947,162,"W-close-F",531785,531947,"chrVII"
"chrVII","YGR026W","+",533988,534013,533924,89,"F-overlap-W",533924,534013,"chrVII"
"chrVII","YGR027C (RPS25A RPS31A)","-",534043,534013,534176,163,"F-close-W",534013,534176,"chrVII"
"chrVII","YGR028W (MSP1 YTA4)","+",543445,543583,543352,231,"W-open-W",543352,543583,"chrVII"
"chrVII","YGR029W (ERV1)","+",544323,544463,544261,202,"W-close-F",544261,544463,"chrVII"
"chrVII","YGR030C (POP6)","-",545587,545550,545649,99,"F-overlap-F",545550,545649,"chrVII"
"chrVII","YGR031C-A (NAG1)","-",546378,546131,546427,296,"W-open-W",546131,546427,"chrVII"
"chrVII","YGR031W","+",547917,547975,547855,120,"F-close-F",547855,547975,"chrVII"
"chrVII","YGR032W (GSC2 FKS2)","+",554035,554188,553839,349,"F-open-W",553839,554188,"chrVII"
"chrVII","YGR033C (TIM21 FMP17)","-",553977,553839,554188,349,"W-open-F",553839,554188,"chrVII"
"chrVII","YGR034W (RPL26B)","+",556786,556863,556677,186,"F-close-F",556677,556863,"chrVII"
"chrVII","YGR035C","-",556905,556863,556932,69,"F-overlap-F",556863,556932,"chrVII"
"chrVII","YGR035W-A","+",557794,557803,557619,184,"F-close-F",557619,557803,"chrVII"
"chrVII","YGR036C (CAX4 CWH8)","-",557509,557411,557619,208,"F-close-W",557411,557619,"chrVII"
"chrVII","YGR037C (ACB1)","-",559512,559450,559571,121,"F-close-F",559450,559571,"chrVII"
"chrVII","YGR038W (ORM1)","+",561488,561627,561319,308,"W-open-F",561319,561627,"chrVII"
"chrVII","YGR039W","+",575250,575410,575207,203,"W-close-W",575207,575410,"chrVII"
"chrVII","YGR040W (KSS1)","+",576999,577062,576885,177,"W-close-W",576885,577062,"chrVII"
"chrVII","YGR041W (BUD9)","+",579250,579265,579086,179,"W-close-W",579086,579265,"chrVII"
"chrVII","YGR042W","+",580375,580448,580229,219,"W-open-F",580229,580448,"chrVII"
"chrVII","YGR043C (NQM1)","-",580254,580229,580448,219,"F-open-W",580229,580448,"chrVII"
"chrVII","YGR044C (RME1 CSP1)","-",582725,582613,582800,187,"F-close-W",582613,582800,"chrVII"
"chrVII","YGR045C","-",583401,583324,583481,157,"F-close-F",583324,583481,"chrVII"
"chrVII","YGR046W (TAM41 MMP37)","+",586393,586461,586266,195,"W-close-F",586266,586461,"chrVII"
"chrVII","YGR047C (TFC4 PCF1)","-",586302,586266,586461,195,"F-close-W",586266,586461,"chrVII"
"chrVII","YGR048W (UFD1)","+",590991,591208,590970,238,"F-open-W",590970,591208,"chrVII"
"chrVII","YGR049W (SCM4)","+",592082,592291,591945,346,"F-open-F",591945,592291,"chrVII"
"chrVII","YGR050C","-",591994,591945,592291,346,"F-open-F",591945,592291,"chrVII"
"chrVII","YGR052W (FMP48)","+",594889,594959,594748,211,"F-close-F",594748,594959,"chrVII"
"chrVII","YGR053C","-",594922,594748,594959,211,"F-close-F",594748,594959,"chrVII"
"chrVII","YGR054W","+",598818,598970,598746,224,"F-open-F",598746,598970,"chrVII"
"chrVII","YGR055W (MUP1)","+",601263,601383,601203,180,"W-close-W",601203,601383,"chrVII"
"chrVII","YGR056W (RSC1)","+",604540,604572,604490,82,"F-overlap-W",604490,604572,"chrVII"
"chrVII","YGR057C (LST7)","-",604436,604341,604490,149,"F-close-F",604341,604490,"chrVII"
"chrVII","YGR058W (PEF1)","+",607435,607592,607367,225,"W-open-W",607367,607592,"chrVII"
"chrVII","YGR059W (SPR3)","+",609199,609459,609081,378,"W-open-W",609081,609459,"chrVII"
"chrVII","YGR060W (ERG25)","+",611689,611867,611488,379,"F-open-F",611488,611867,"chrVII"
"chrVII","YGR061C (ADE6)","-",611812,NA,NA,NA,"+1_missing",611488,611867,"chrVII"
"chrVII","YGR062C (COX18 OXA2)","-",616251,616057,616350,293,"W-open-W",616057,616350,"chrVII"
"chrVII","YGR063C (SPT4)","-",617384,617265,617625,360,"W-open-W",617265,617625,"chrVII"
"chrVII","YGR064W","+",618119,618263,618095,168,"W-close-W",618095,618263,"chrVII"
"chrVII","YGR065C (VHT1)","-",617982,617798,618095,297,"W-open-W",617798,618095,"chrVII"
"chrVII","YGR066C","-",620756,620621,620825,204,"F-close-W",620621,620825,"chrVII"
"chrVII","YGR067C","-",622263,622187,622298,111,"W-overlap-F",622187,622298,"chrVII"
"chrVII","YGR068C (ART5)","-",624929,624947,625122,175,"W-close-W",624947,625122,"chrVII"
"chrVII","YGR070W (ROM1 SKC1)","+",631453,631617,631228,389,"W-open-F",631228,631617,"chrVII"
"chrVII","YGR071C","-",631290,631228,NA,NA,"-1_missing",631228,631617,"chrVII"
"chrVII","YGR072W (UPF3 SUA6 SUP112)","+",635582,635739,635430,309,"W-open-W",635430,635739,"chrVII"
"chrVII","YGR073C","-",635580,635430,635739,309,"W-open-W",635430,635739,"chrVII"
"chrVII","YGR074W (SMD1 SPP92)","+",636452,636538,636357,181,"F-close-W",636357,636538,"chrVII"
"chrVII","YGR075C (PRP38)","-",635726,635739,635894,155,"W-close-W",635739,635894,"chrVII"
"chrVII","YGR076C (MRPL25 AFO1 YMR26)","-",637006,636873,637070,197,"F-close-W",636873,637070,"chrVII"
"chrVII","YGR077C (PEX8 PAS6)","-",637692,637578,637826,248,"W-open-W",637578,637826,"chrVII"
"chrVII","YGR078C (PAC10 GIM2 PFD3 RKS2)","-",639697,639502,639760,258,"W-open-W",639502,639760,"chrVII"
"chrVII","YGR079W","+",641923,642023,641757,266,"W-open-W",641757,642023,"chrVII"
"chrVII","YGR080W (TWF1)","+",643096,643093,642929,164,"F-close-F",642929,643093,"chrVII"
"chrVII","YGR081C (SLX9)","-",643036,642929,643093,164,"F-close-F",642929,643093,"chrVII"
"chrVII","YGR082W (TOM20 MAS20 MOM19)","+",644743,644890,644714,176,"F-close-W",644714,644890,"chrVII"
"chrVII","YGR083C (GCD2 GCD12)","-",644637,644564,644714,150,"F-close-W",644564,644714,"chrVII"
"chrVII","YGR084C (MRP13)","-",647047,646826,647108,282,"W-open-W",646826,647108,"chrVII"
"chrVII","YGR085C (RPL11B)","-",648288,648050,648318,268,"W-open-W",648050,648318,"chrVII"
"chrVII","YGR086C (PIL1)","-",649324,649313,649501,188,"W-close-F",649313,649501,"chrVII"
"chrVII","YGR087C (PDC6)","-",651175,NA,NA,NA,"+1_missing",650706,651315,"chrVII"
"chrVII","YGR088W (CTT1 SPS101)","+",656408,656428,656254,174,"W-close-W",656254,656428,"chrVII"
"chrVII","YGR089W (NNF2)","+",659900,660095,659843,252,"W-open-W",659843,660095,"chrVII"
"chrVII","YGR090W (UTP22)","+",666186,666320,665940,380,"W-open-W",665940,666320,"chrVII"
"chrVII","YGR091W (PRP31)","+",667936,668077,667765,312,"W-open-W",667765,668077,"chrVII"
"chrVII","YGR092W (DBF2)","+",670051,670099,669907,192,"W-close-W",669907,670099,"chrVII"
"chrVII","YGR093W","+",671992,672212,671931,281,"W-open-W",671931,672212,"chrVII"
"chrVII","YGR094W (VAS1)","+",675590,675619,675420,199,"F-close-F",675420,675619,"chrVII"
"chrVII","YGR095C (RRP46)","-",675626,675619,675724,105,"F-overlap-F",675619,675724,"chrVII"
"chrVII","YGR096W (TPC1)","+",677636,NA,NA,NA,"+1_missing",677530,677985,"chrVII"
"chrVII","YGR097W (ASK10 RGC2)","+",682297,682338,682223,115,"F-overlap-F",682223,682338,"chrVII"
"chrVII","YGR098C (ESP1)","-",682323,682338,682424,86,"F-overlap-F",682338,682424,"chrVII"
"chrVII","YGR099W (TEL2)","+",690028,690202,689940,262,"W-open-W",689940,690202,"chrVII"
"chrVII","YGR100W (MDR1 GYP2 MIC1)","+",693214,693354,693095,259,"W-open-W",693095,693354,"chrVII"
"chrVII","YGR101W (PCP1 MDM37 RBD1)","+",694487,694600,694408,192,"F-close-W",694408,694600,"chrVII"
"chrVII","YGR102C","-",694431,694408,694600,192,"W-close-F",694408,694600,"chrVII"
"chrVII","YGR103W (NOP7 YPH1)","+",697394,697380,697181,199,"F-close-F",697181,697380,"chrVII"
"chrVII","YGR104C (SRB5 MED18)","-",697419,697380,697523,143,"W-close-F",697380,697523,"chrVII"
"chrVII","YGR105W (VMA21)","+",699004,699129,698959,170,"F-close-W",698959,699129,"chrVII"
"chrVII","YGR106C (VOA1)","-",698892,698772,698959,187,"F-close-W",698772,698959,"chrVII"
"chrVII","YGR107W","+",703383,703405,703327,78,"W-overlap-F",703327,703405,"chrVII"
"chrVII","YGR108W (CLB1 SCB1)","+",705227,705357,705190,167,"F-close-W",705190,705357,"chrVII"
"chrVII","YGR109C (CLB6)","-",705245,705190,705357,167,"W-close-F",705190,705357,"chrVII"
"chrVII","YGR110W (CLD1)","+",715146,715206,715039,167,"F-close-W",715039,715206,"chrVII"
"chrVII","YGR111W","+",717149,717345,717088,257,"W-open-W",717088,717345,"chrVII"
"chrVII","YGR112W (SHY1)","+",718699,718867,718600,267,"W-open-W",718600,718867,"chrVII"
"chrVII","YGR113W (DAM1)","+",720222,720390,720089,301,"W-open-W",720089,720390,"chrVII"
"chrVII","YGR116W (SPT6 CRE2 SSN20)","+",724955,725053,724903,150,"F-close-F",724903,725053,"chrVII"
"chrVII","YGR117C","-",724782,724680,724818,138,"F-close-F",724680,724818,"chrVII"
"chrVII","YGR118W (RPS23A)","+",727903,727988,727674,314,"F-open-F",727674,727988,"chrVII"
"chrVII","YGR119C (NUP57)","-",727960,727674,727988,314,"F-open-F",727674,727988,"chrVII"
"chrVII","YGR120C (COG2 SEC35)","-",729862,729708,729997,289,"W-open-W",729708,729997,"chrVII"
"chrVII","YGR121C (MEP1 AMT1)","-",731304,731017,731381,364,"W-open-F",731017,731381,"chrVII"
"chrVII","YGR122C-A","-",735188,735147,735331,184,"W-close-W",735147,735331,"chrVII"
"chrVII","YGR122W","+",735473,735480,735331,149,"W-close-F",735331,735480,"chrVII"
"chrVII","YGR123C (PPT1)","-",736501,NA,NA,NA,"+1_missing",736006,736542,"chrVII"
"chrVII","YGR124W (ASN2)","+",741819,741831,741654,177,"W-close-W",741654,741831,"chrVII"
"chrVII","YGR125W","+",745588,745655,745490,165,"W-close-F",745490,745655,"chrVII"
"chrVII","YGR126W","+",746725,746784,746536,248,"W-open-W",746536,746784,"chrVII"
"chrVII","YGR127W","+",747951,747996,747821,175,"W-close-F",747821,747996,"chrVII"
"chrVII","YGR128C (UTP8)","-",747830,747821,747996,175,"F-close-W",747821,747996,"chrVII"
"chrVII","YGR129W (SYF2 NTC31)","+",751325,751357,751232,125,"W-close-F",751232,751357,"chrVII"
"chrVII","YGR130C","-",751219,751232,751357,125,"F-close-W",751232,751357,"chrVII"
"chrVII","YGR131W (FHN1)","+",755350,755432,755247,185,"W-close-W",755247,755432,"chrVII"
"chrVII","YGR132C (PHB1)","-",755345,755247,755432,185,"W-close-W",755247,755432,"chrVII"
"chrVII","YGR133W (PEX4 PAS2 UBC10)","+",757652,757669,757427,242,"W-open-W",757427,757669,"chrVII"
"chrVII","YGR134W (CAF130)","+",761305,761372,761104,268,"W-open-W",761104,761372,"chrVII"
"chrVII","YGR135W (PRE9)","+",762247,762449,762144,305,"W-open-F",762144,762449,"chrVII"
"chrVII","YGR136W (LSB1)","+",763206,763261,763120,141,"F-close-F",763120,763261,"chrVII"
"chrVII","YGR138C (TPO2)","-",763583,763584,763786,202,"W-close-F",763584,763786,"chrVII"
"chrVII","YGR141W (VPS62)","+",772339,772512,772316,196,"W-close-W",772316,772512,"chrVII"
"chrVII","YGR142W (BTN2)","+",773781,773854,773674,180,"W-close-W",773674,773854,"chrVII"
"chrVII","YGR143W (SKN1)","+",777899,777975,777770,205,"W-close-F",777770,777975,"chrVII"
"chrVII","YGR145W (ENP2)","+",783966,784022,783827,195,"W-close-W",783827,784022,"chrVII"
"chrVII","YGR146C (ECL1)","-",784046,784022,784226,204,"F-close-W",784022,784226,"chrVII"
"chrVII","YGR146C-A","-",785103,785043,785159,116,"W-overlap-F",785043,785159,"chrVII"
"chrVII","YGR147C (NAT2)","-",785936,785788,785958,170,"W-close-W",785788,785958,"chrVII"
"chrVII","YGR148C (RPL24B RPL30B)","-",787178,786952,787201,249,"W-open-W",786952,787201,"chrVII"
"chrVII","YGR149W","+",790484,790466,790387,79,"F-overlap-F",790387,790466,"chrVII"
"chrVII","YGR150C (CCM1 DMR1 RRG2)","-",790337,790286,790387,101,"F-overlap-F",790286,790387,"chrVII"
"chrVII","YGR151C","-",794577,NA,NA,NA,"+1_missing",794275,794622,"chrVII"
"chrVII","YGR152C (RSR1 BUD1)","-",794577,NA,NA,NA,"+1_missing",794275,794622,"chrVII"
"chrVII","YGR153W (TOS10)","+",796842,796856,796778,78,"W-overlap-F",796778,796856,"chrVII"
"chrVII","YGR154C (GTO1)","-",796577,796447,796612,165,"W-close-W",796447,796612,"chrVII"
"chrVII","YGR155W (CYS4 NHS5 STR4 VMA41)","+",800198,800408,800131,277,"W-open-W",800131,800408,"chrVII"
"chrVII","YGR156W (PTI1)","+",801915,802203,801890,313,"W-open-W",801890,802203,"chrVII"
"chrVII","YGR157W (CHO2 PEM1)","+",805155,805163,805052,111,"F-overlap-W",805052,805163,"chrVII"
"chrVII","YGR158C (MTR3)","-",805044,805052,805163,111,"W-overlap-F",805052,805163,"chrVII"
"chrVII","YGR159C (NSR1 SHE5)","-",806268,806051,806361,310,"F-open-W",806051,806361,"chrVII"
"chrVII","YGR160W","+",808004,808102,807725,377,"W-open-W",807725,808102,"chrVII"
"chrVII","YGR161C (RTS3)","-",808467,808485,808650,165,"F-close-F",808485,808650,"chrVII"
"chrVII","YGR161W-C","+",810769,810769,810639,130,"F-close-F",810639,810769,"chrVII"
"chrVII","YGR162W (TIF4631)","+",827329,827538,827282,256,"W-open-W",827282,827538,"chrVII"
"chrVII","YGR163W (GTR2)","+",828615,NA,NA,NA,"+1_missing",828594,828923,"chrVII"
"chrVII","YGR165W (MRPS35)","+",830294,830487,830249,238,"W-open-W",830249,830487,"chrVII"
"chrVII","YGR166W (TRS65 KRE11)","+",832273,832432,832152,280,"W-open-W",832152,832432,"chrVII"
"chrVII","YGR167W (CLC1 SCD4)","+",833317,833427,833254,173,"F-close-F",833254,833427,"chrVII"
"chrVII","YGR168C","-",833270,833254,833427,173,"F-close-F",833254,833427,"chrVII"
"chrVII","YGR169C (PUS6)","-",834590,834497,834742,245,"W-open-W",834497,834742,"chrVII"
"chrVII","YGR169C-A (YGR169C-C)","-",836011,835873,836042,169,"F-close-W",835873,836042,"chrVII"
"chrVII","YGR170W (PSD2)","+",840833,840831,840668,163,"W-close-W",840668,840831,"chrVII"
"chrVII","YGR171C (MSM1)","-",840710,840668,840831,163,"W-close-W",840668,840831,"chrVII"
"chrVII","YGR172C (YIP1)","-",842718,842520,842739,219,"W-open-W",842520,842739,"chrVII"
"chrVII","YGR173W (RBG2 GIR1)","+",845009,845146,844985,161,"F-close-W",844985,845146,"chrVII"
"chrVII","YGR174C (CBP4)","-",845766,845673,845850,177,"F-close-F",845673,845850,"chrVII"
"chrVII","YGR174W-A","+",846846,846841,846715,126,"W-close-F",846715,846841,"chrVII"
"chrVII","YGR175C (ERG1)","-",846754,846715,846841,126,"F-close-W",846715,846841,"chrVII"
"chrVII","YGR177C (ATF2)","-",848618,848400,848673,273,"W-open-W",848400,848673,"chrVII"
"chrVII","YGR178C (PBP1 MRS16)","-",850924,850749,851009,260,"F-open-W",850749,851009,"chrVII"
"chrVII","YGR179C (OKP1)","-",853543,853419,853715,296,"W-open-W",853419,853715,"chrVII"
"chrVII","YGR180C (RNR4 CRT3 PSO3)","-",855142,854899,855200,301,"F-open-W",854899,855200,"chrVII"
"chrVII","YGR181W (TIM13)","+",858785,858829,858751,78,"F-overlap-F",858751,858829,"chrVII"
"chrVII","YGR182C","-",858131,858024,858283,259,"W-open-W",858024,858283,"chrVII"
"chrVII","YGR183C (QCR9 UCR9)","-",858911,858899,859009,110,"W-overlap-F",858899,859009,"chrVII"
"chrVII","YGR184C (UBR1 PTR1)","-",859819,859535,859865,330,"F-open-W",859535,859865,"chrVII"
"chrVII","YGR185C (TYS1 TTS1 TyrRS)","-",866242,866109,866382,273,"W-open-W",866109,866382,"chrVII"
"chrVII","YGR186W (TFG1 RAP74 SSU71)","+",870037,870091,869986,105,"F-overlap-F",869986,870091,"chrVII"
"chrVII","YGR187C (HGH1)","-",870094,870091,870187,96,"F-overlap-F",870091,870187,"chrVII"
"chrVII","YGR188C (BUB1)","-",871857,871738,871953,215,"F-close-W",871738,871953,"chrVII"
"chrVII","YGR189C (CRH1)","-",876550,876413,876614,201,"F-close-F",876413,876614,"chrVII"
"chrVII","YGR191W (HIP1)","+",882449,882434,882348,86,"F-overlap-F",882348,882434,"chrVII"
"chrVII","YGR192C (TDH3 GLD1 HSP35 HSP36 SSS2)","-",882706,882655,882874,219,"F-open-F",882655,882874,"chrVII"
"chrVII","YGR193C (PDX1)","-",884405,884127,884532,405,"W-open-W",884127,884532,"chrVII"
"chrVII","YGR194C (XKS1)","-",885970,885791,886039,248,"W-open-W",885791,886039,"chrVII"
"chrVII","YGR195W (SKI6 ECM20 RRP41)","+",889701,889815,889610,205,"F-close-F",889610,889815,"chrVII"
"chrVII","YGR196C (FYV8)","-",889621,889610,889815,205,"F-close-F",889610,889815,"chrVII"
"chrVII","YGR197C (SNG1)","-",892431,892190,892502,312,"W-open-W",892190,892502,"chrVII"
"chrVII","YGR198W (YPP1)","+",897247,897229,897064,165,"W-close-F",897064,897229,"chrVII"
"chrVII","YGR199W (PMT6)","+",899782,899785,899688,97,"W-overlap-F",899688,899785,"chrVII"
"chrVII","YGR200C (ELP2 KTI3 TOT2)","-",899829,899785,899884,99,"F-overlap-F",899785,899884,"chrVII"
"chrVII","YGR201C","-",902452,902285,902554,269,"W-open-W",902285,902554,"chrVII"
"chrVII","YGR202C (PCT1 BSR2 CCT1)","-",903346,903263,903414,151,"F-close-F",903263,903414,"chrVII"
"chrVII","YGR203W (YCH1)","+",905868,905918,NA,NA,"-1_missing",905304,905918,"chrVII"
"chrVII","YGR204C-A","-",908812,908783,NA,NA,"-1_missing",908783,909117,"chrVII"
"chrVII","YGR204W (ADE3)","+",908860,909117,908783,334,"F-open-W",908783,909117,"chrVII"
"chrVII","YGR205W","+",910210,910217,910047,170,"W-close-W",910047,910217,"chrVII"
"chrVII","YGR206W (MVB12)","+",910824,910965,910795,170,"F-close-W",910795,910965,"chrVII"
"chrVII","YGR207C","-",910733,910648,910795,147,"F-close-W",910648,910795,"chrVII"
"chrVII","YGR208W (SER2)","+",912886,912920,912715,205,"W-close-W",912715,912920,"chrVII"
"chrVII","YGR209C (TRX2 LMA1)","-",912830,912715,912920,205,"W-close-W",912715,912920,"chrVII"
"chrVII","YGR210C","-",913394,913273,913538,265,"W-open-W",913273,913538,"chrVII"
"chrVII","YGR211W (ZPR1)","+",916893,917052,916861,191,"F-close-W",916861,917052,"chrVII"
"chrVII","YGR212W (SLI1)","+",919553,919619,919441,178,"W-close-W",919441,919619,"chrVII"
"chrVII","YGR213C (RTA1)","-",918369,918347,918424,77,"W-overlap-F",918347,918424,"chrVII"
"chrVII","YGR214W (RPS0A NAB1 NAB1A YST1)","+",921905,921902,921724,178,"W-close-W",921724,921902,"chrVII"
"chrVII","YGR215W (RSM27)","+",922621,922680,922472,208,"W-close-W",922472,922680,"chrVII"
"chrVII","YGR216C (GPI1)","-",922510,922472,922680,208,"W-close-W",922472,922680,"chrVII"
"chrVII","YGR217W (CCH1)","+",930880,931174,930805,369,"W-open-W",930805,931174,"chrVII"
"chrVII","YGR218W (CRM1 KAP124 XPO1)","+",935994,936021,935936,85,"F-overlap-F",935936,936021,"chrVII"
"chrVII","YGR220C (MRPL9)","-",935991,935936,936021,85,"F-overlap-F",935936,936021,"chrVII"
"chrVII","YGR221C (TOS2)","-",937061,936853,937122,269,"W-open-W",936853,937122,"chrVII"
"chrVII","YGR222W (PET54)","+",940896,940935,940775,160,"W-close-W",940775,940935,"chrVII"
"chrVII","YGR223C (HSV2)","-",940796,940775,940935,160,"W-close-W",940775,940935,"chrVII"
"chrVII","YGR224W (AZR1)","+",944867,945087,944817,270,"W-open-W",944817,945087,"chrVII"
"chrVII","YGR225W (AMA1 SPO70)","+",947138,947127,946949,178,"W-close-F",946949,947127,"chrVII"
"chrVII","YGR227W (DIE2 ALG10)","+",949114,949179,948983,196,"F-close-W",948983,949179,"chrVII"
"chrVII","YGR229C (SMI1 KNR4)","-",949194,949179,949370,191,"F-close-W",949179,949370,"chrVII"
"chrVII","YGR230W (BNS1)","+",952436,952516,952316,200,"F-close-W",952316,952516,"chrVII"
"chrVII","YGR231C (PHB2)","-",952332,952316,952516,200,"W-close-F",952316,952516,"chrVII"
"chrVII","YGR232W (NAS6)","+",954701,954803,954677,126,"F-close-W",954677,954803,"chrVII"
"chrVII","YGR233C (PHO81 VAC6 phoS)","-",954611,954485,954677,192,"F-close-W",954485,954677,"chrVII"
"chrVII","YGR234W (YHB1 YHB4)","+",961377,961405,961228,177,"F-close-W",961228,961405,"chrVII"
"chrVII","YGR235C","-",961249,961228,961405,177,"W-close-F",961228,961405,"chrVII"
"chrVII","YGR236C (SPG1)","-",962337,962330,962546,216,"F-open-F",962330,962546,"chrVII"
"chrVII","YGR237C","-",963135,963010,963204,194,"F-close-F",963010,963204,"chrVII"
"chrVII","YGR238C (KEL2)","-",965918,965676,965979,303,"W-open-W",965676,965979,"chrVII"
"chrVII","YGR239C (PEX21)","-",969092,969037,969246,209,"W-close-W",969037,969246,"chrVII"
"chrVII","YGR240C (PFK1)","-",970548,970394,970588,194,"F-close-W",970394,970588,"chrVII"
"chrVII","YGR240C-A","-",973972,973944,NA,NA,"-1_missing",973944,974414,"chrVII"
"chrVII","YGR241C (YAP1802)","-",974803,974815,974998,183,"W-close-F",974815,974998,"chrVII"
"chrVII","YGR243W (FMP43)","+",977890,978096,977747,349,"W-open-W",977747,978096,"chrVII"
"chrVII","YGR244C (LSC2)","-",977959,977747,978096,349,"W-open-W",977747,978096,"chrVII"
"chrVII","YGR245C (SDA1)","-",979687,979704,979867,163,"F-close-W",979704,979867,"chrVII"
"chrVII","YGR246C (BRF1 PCF4 TDS4)","-",982317,982112,982424,312,"F-open-W",982112,982424,"chrVII"
"chrVII","YGR247W (CPD1)","+",985813,985883,985651,232,"F-open-F",985651,985883,"chrVII"
"chrVII","YGR248W (SOL4)","+",986841,NA,NA,NA,"+1_missing",986741,987814,"chrVII"
"chrVII","YGR249W (MGA1)","+",989914,990022,989715,307,"W-open-W",989715,990022,"chrVII"
"chrVII","YGR250C","-",991065,991039,991207,168,"F-close-F",991039,991207,"chrVII"
"chrVII","YGR251W","+",996613,996868,996581,287,"F-open-W",996581,996868,"chrVII"
"chrVII","YGR252W (GCN5 AAS104 ADA4 SWI9)","+",998396,998512,998343,169,"W-close-F",998343,998512,"chrVII"
"chrVII","YGR253C (PUP2 DOA5)","-",998280,998207,998343,136,"W-close-F",998207,998343,"chrVII"
"chrVII","YGR254W (ENO1 HSP48)","+",1002388,1002434,1002156,278,"F-open-F",1002156,1002434,"chrVII"
"chrVII","YGR255C (COQ6)","-",1002452,1002434,1002558,124,"F-close-F",1002434,1002558,"chrVII"
"chrVII","YGR256W (GND2)","+",1006214,1006378,1006034,344,"F-open-W",1006034,1006378,"chrVII"
"chrVII","YGR257C (MTM1)","-",1006139,1006034,1006378,344,"W-open-F",1006034,1006378,"chrVII"
"chrVII","YGR258C (RAD2)","-",1007621,1007561,1007642,81,"F-overlap-F",1007561,1007642,"chrVII"
"chrVII","YGR259C","-",1012217,1012074,1012241,167,"W-close-F",1012074,1012241,"chrVII"
"chrVII","YGR260W (TNA1)","+",1014214,1014285,1014167,118,"F-overlap-F",1014167,1014285,"chrVII"
"chrVII","YGR261C (APL6 YKS5)","-",1014232,1014167,1014285,118,"F-overlap-F",1014167,1014285,"chrVII"
"chrVII","YGR262C (BUD32 LDB14)","-",1016866,1016724,1017003,279,"W-open-W",1016724,1017003,"chrVII"
"chrVII","YGR263C (SAY1)","-",1017896,1017740,1017988,248,"W-open-W",1017740,1017988,"chrVII"
"chrVII","YGR264C (MES1 MESI)","-",1019406,1019224,1019431,207,"W-close-F",1019224,1019431,"chrVII"
"chrVII","YGR266W","+",1024917,1024943,1024872,71,"F-overlap-F",1024872,1024943,"chrVII"
"chrVII","YGR267C (FOL2)","-",1024916,1024872,1024943,71,"F-overlap-F",1024872,1024943,"chrVII"
"chrVII","YGR268C (HUA1)","-",1025804,1025678,1025864,186,"W-close-W",1025678,1025864,"chrVII"
"chrVII","YGR269W","+",1027005,1027279,1026958,321,"W-open-W",1026958,1027279,"chrVII"
"chrVII","YGR270W (YTA7)","+",1031580,1031801,1031529,272,"W-open-W",1031529,1031801,"chrVII"
"chrVII","YGR271C-A (EFG1 YGR272C)","-",1037702,1037655,1037805,150,"F-close-F",1037655,1037805,"chrVII"
"chrVII","YGR271W (SLH1)","+",1037833,1037990,1037805,185,"F-close-W",1037805,1037990,"chrVII"
"chrVII","YGR273C","-",1038606,1038487,1038773,286,"W-open-W",1038487,1038773,"chrVII"
"chrVII","YGR274C (TAF1 TAF130 TAF145)","-",1039810,1039792,1039915,123,"F-close-W",1039792,1039915,"chrVII"
"chrVII","YGR275W (RTT102)","+",1043841,1043972,1043640,332,"W-open-W",1043640,1043972,"chrVII"
"chrVII","YGR276C (RNH70 REX1 RNA82)","-",1043229,1043056,1043313,257,"W-open-W",1043056,1043313,"chrVII"
"chrVII","YGR277C (CAB4)","-",1045568,1045443,1045693,250,"W-open-W",1045443,1045693,"chrVII"
"chrVII","YGR278W (CWC22)","+",1048534,1048687,1048511,176,"F-close-F",1048511,1048687,"chrVII"
"chrVII","YGR279C (SCW4)","-",1048545,1048511,1048687,176,"F-close-F",1048511,1048687,"chrVII"
"chrVII","YGR280C (PXR1 GNO1)","-",1050689,1050634,1050722,88,"W-overlap-F",1050634,1050722,"chrVII"
"chrVII","YGR281W (YOR1 YRS1)","+",1057426,1057412,1057329,83,"F-overlap-W",1057329,1057412,"chrVII"
"chrVII","YGR282C (BGL2)","-",1057582,1057496,1057608,112,"F-overlap-F",1057496,1057608,"chrVII"
"chrVII","YGR283C","-",1058911,1058743,1059077,334,"W-open-W",1058743,1059077,"chrVII"
"chrVII","YGR284C (ERV29)","-",1060473,1060478,1060642,164,"W-close-W",1060478,1060642,"chrVII"
"chrVII","YGR285C (ZUO1)","-",1061781,1061619,1061903,284,"W-open-W",1061619,1061903,"chrVII"
"chrVII","YGR286C (BIO2)","-",1063667,1063654,1063740,86,"F-overlap-W",1063654,1063740,"chrVII"
"chrVII","YGR287C (IMA1)","-",1067073,1066955,1067135,180,"F-close-W",1066955,1067135,"chrVII"
"chrVII","YGR288W (MAL13 MALR)","+",1072203,1072343,1072156,187,"W-close-W",1072156,1072343,"chrVII"
"chrVII","YGR289C (MAL11 AGT1 MALT)","-",1073806,1073743,1073944,201,"W-close-W",1073743,1073944,"chrVII"
"chrVII","YGR292W (MAL12 MALS)","+",1078482,NA,NA,NA,"+1_missing",1076583,1078808,"chrVII"
"chrVIII","YHL001W (RPL14B)","+",105214,105224,105073,151,"F-close-F",105073,105224,"chrVIII"
"chrVIII","YHL002W (HSE1)","+",104029,104301,103907,394,"W-open-W",103907,104301,"chrVIII"
"chrVIII","YHL003C (LAG1)","-",100412,100338,100472,134,"F-close-W",100338,100472,"chrVIII"
"chrVIII","YHL004W (MRP4)","+",100504,100541,100472,69,"F-overlap-F",100472,100541,"chrVIII"
"chrVIII","YHL006C (SHU1)","-",98033,98044,NA,NA,"-1_missing",98044,98438,"chrVIII"
"chrVIII","YHL006W-A","+",98157,98438,98044,394,"W-open-W",98044,98438,"chrVIII"
"chrVIII","YHL007C (STE20)","-",94977,94989,95068,79,"F-overlap-F",94989,95068,"chrVIII"
"chrVIII","YHL008C","-",92455,92377,92490,113,"F-overlap-F",92377,92490,"chrVIII"
"chrVIII","YHL009C (YAP3)","-",83818,83723,83979,256,"W-open-W",83723,83979,"chrVIII"
"chrVIII","YHL010C (ETP1 BRP2)","-",81795,81730,82031,301,"W-open-W",81730,82031,"chrVIII"
"chrVIII","YHL011C (PRS3)","-",80442,80421,80573,152,"W-close-F",80421,80573,"chrVIII"
"chrVIII","YHL012W","+",80606,80750,80573,177,"W-close-W",80573,80750,"chrVIII"
"chrVIII","YHL013C (OTU2)","-",77326,77263,77443,180,"F-close-W",77263,77443,"chrVIII"
"chrVIII","YHL014C (YLF2 YLF1)","-",76037,75897,76080,183,"F-close-W",75897,76080,"chrVIII"
"chrVIII","YHL015W (RPS20 URP2)","+",75834,75897,75738,159,"W-close-W",75738,75897,"chrVIII"
"chrVIII","YHL016C (DUR3)","-",71923,71832,72091,259,"F-open-F",71832,72091,"chrVIII"
"chrVIII","YHL017W","+",72009,72091,71832,259,"F-open-F",71832,72091,"chrVIII"
"chrVIII","YHL019C (APM2)","-",67643,67502,67764,262,"W-open-W",67502,67764,"chrVIII"
"chrVIII","YHL020C (OPI1)","-",66126,65976,66160,184,"F-close-W",65976,66160,"chrVIII"
"chrVIII","YHL021C (AIM17 FMP12)","-",64373,64182,64479,297,"F-open-F",64182,64479,"chrVIII"
"chrVIII","YHL023C (NPR3 RMD11)","-",59050,59007,59211,204,"W-close-F",59007,59211,"chrVIII"
"chrVIII","YHL024W (RIM4)","+",58841,58827,58681,146,"W-close-F",58681,58827,"chrVIII"
"chrVIII","YHL025W (SNF6)","+",55952,55990,55864,126,"F-close-F",55864,55990,"chrVIII"
"chrVIII","YHL026C","-",53097,53025,53269,244,"F-open-W",53025,53269,"chrVIII"
"chrVIII","YHL027W (RIM101 RIM1)","+",53189,53269,53025,244,"W-open-F",53025,53269,"chrVIII"
"chrVIII","YHL028W (WSC4 YFW1 YHC8)","+",50660,50831,50540,291,"W-open-F",50540,50831,"chrVIII"
"chrVIII","YHL029C (OCA5)","-",45863,45811,45930,119,"F-overlap-F",45811,45930,"chrVIII"
"chrVIII","YHL030W (ECM29)","+",45800,45811,45626,185,"W-close-F",45626,45811,"chrVIII"
"chrVIII","YHL030W-A","+",39588,39684,39468,216,"W-open-F",39468,39684,"chrVIII"
"chrVIII","YHL031C (GOS1)","-",38755,38539,38800,261,"W-open-W",38539,38800,"chrVIII"
"chrVIII","YHL032C (GUT1)","-",36324,NA,NA,NA,"+1_missing",36010,36382,"chrVIII"
"chrVIII","YHL033C (RPL8A MAK7)","-",34848,34767,34870,103,"F-overlap-F",34767,34870,"chrVIII"
"chrVIII","YHL034C (SBP1 SSB1 SSBR1)","-",33041,32991,33193,202,"W-close-W",32991,33193,"chrVIII"
"chrVIII","YHL034W-A","+",34204,34410,34139,271,"W-open-W",34139,34410,"chrVIII"
"chrVIII","YHL035C (VMR1)","-",27794,27723,27830,107,"F-overlap-W",27723,27830,"chrVIII"
"chrVIII","YHL036W (MUP3)","+",27955,27982,27830,152,"F-close-F",27830,27982,"chrVIII"
"chrVIII","YHL037C","-",25767,25762,25938,176,"W-close-W",25762,25938,"chrVIII"
"chrVIII","YHL038C (CBP2)","-",23476,23495,23685,190,"F-close-F",23495,23685,"chrVIII"
"chrVIII","YHL039W (EFM1)","+",23608,23685,23495,190,"F-close-F",23495,23685,"chrVIII"
"chrVIII","YHL040C (ARN1)","-",18808,18767,18875,108,"F-overlap-F",18767,18875,"chrVIII"
"chrVIII","YHL042W","+",16417,16472,16288,184,"W-close-W",16288,16472,"chrVIII"
"chrVIII","YHL044W","+",14555,14616,14432,184,"W-close-F",14432,14616,"chrVIII"
"chrVIII","YHL047C (ARN2 TAF1)","-",8183,8064,8243,179,"W-close-W",8064,8243,"chrVIII"
"chrVIII","YHL048W (COS8)","+",7648,7860,7570,290,"F-open-W",7570,7860,"chrVIII"
"chrVIII","YHR001W (OSH7)","+",107461,107494,107315,179,"W-close-W",107315,107494,"chrVIII"
"chrVIII","YHR001W-A (QCR10)","+",108346,108439,108273,166,"F-close-W",108273,108439,"chrVIII"
"chrVIII","YHR002W (LEU5)","+",110023,110136,109993,143,"F-close-F",109993,110136,"chrVIII"
"chrVIII","YHR003C","-",109911,109863,109993,130,"F-close-F",109863,109993,"chrVIII"
"chrVIII","YHR004C (NEM1)","-",111642,111518,111690,172,"W-close-F",111518,111690,"chrVIII"
"chrVIII","YHR005C (GPA1 CDC70 DAC1 SCG1)","-",113398,113195,113424,229,"F-open-W",113195,113424,"chrVIII"
"chrVIII","YHR005C-A (TIM10 MRS11)","-",115458,115426,115524,98,"F-overlap-F",115426,115524,"chrVIII"
"chrVIII","YHR006W (STP2)","+",119566,119549,119404,145,"W-close-F",119404,119549,"chrVIII"
"chrVIII","YHR007C (ERG11 CYP51)","-",119817,119784,119969,185,"W-close-F",119784,119969,"chrVIII"
"chrVIII","YHR007C-A","-",121826,121682,121877,195,"F-close-W",121682,121877,"chrVIII"
"chrVIII","YHR008C (SOD2)","-",122798,122652,122911,259,"F-open-W",122652,122911,"chrVIII"
"chrVIII","YHR009C","-",123993,123939,124130,191,"W-close-F",123939,124130,"chrVIII"
"chrVIII","YHR010W (RPL27A RPL27)","+",127613,127781,127379,402,"F-open-W",127379,127781,"chrVIII"
"chrVIII","YHR011W (DIA4)","+",129182,129274,129107,167,"F-close-F",129107,129274,"chrVIII"
"chrVIII","YHR012W (VPS29 PEP11 VPT6)","+",130744,130786,130715,71,"F-overlap-W",130715,130786,"chrVIII"
"chrVIII","YHR013C (ARD1 NAA10)","-",130634,130636,130715,79,"F-overlap-W",130636,130715,"chrVIII"
"chrVIII","YHR015W (MIP6)","+",136631,136698,136516,182,"W-close-W",136516,136698,"chrVIII"
"chrVIII","YHR016C (YSC84 LSB4)","-",136743,136698,136868,170,"W-close-W",136698,136868,"chrVIII"
"chrVIII","YHR017W (YSC83)","+",139928,139923,139758,165,"F-close-F",139758,139923,"chrVIII"
"chrVIII","YHR018C (ARG4)","-",139850,139758,139923,165,"F-close-F",139758,139923,"chrVIII"
"chrVIII","YHR019C (DED81)","-",141791,141695,141890,195,"W-close-W",141695,141890,"chrVIII"
"chrVIII","YHR020W","+",146146,146303,146115,188,"F-close-F",146115,146303,"chrVIII"
"chrVIII","YHR021C (RPS27B)","-",147778,147718,147962,244,"F-open-F",147718,147962,"chrVIII"
"chrVIII","YHR021W-A (ECM12)","+",150572,150579,150433,146,"F-close-F",150433,150579,"chrVIII"
"chrVIII","YHR022C","-",149212,NA,NA,NA,"+1_missing",148715,149273,"chrVIII"
"chrVIII","YHR022C-A","-",150493,150433,150579,146,"F-close-F",150433,150579,"chrVIII"
"chrVIII","YHR023W (MYO1)","+",157554,157581,157404,177,"W-close-F",157404,157581,"chrVIII"
"chrVIII","YHR024C (MAS2 MIF2)","-",157521,157404,157581,177,"F-close-W",157404,157581,"chrVIII"
"chrVIII","YHR025W (THR1)","+",160597,160770,160477,293,"W-open-W",160477,160770,"chrVIII"
"chrVIII","YHR026W (VMA16 PPA1)","+",161686,161786,161543,243,"F-open-F",161543,161786,"chrVIII"
"chrVIII","YHR027C (RPN1 HRD2 NAS1)","-",161584,161543,161786,243,"F-open-F",161543,161786,"chrVIII"
"chrVIII","YHR028C (DAP2 DPP2)","-",164874,164722,165000,278,"W-open-W",164722,165000,"chrVIII"
"chrVIII","YHR029C (YHI9)","-",167595,167442,167720,278,"W-open-W",167442,167720,"chrVIII"
"chrVIII","YHR030C (SLT2 BYC2 MPK1 SLK2)","-",168749,168545,168778,233,"F-open-F",168545,168778,"chrVIII"
"chrVIII","YHR031C (RRM3 RTT104)","-",170666,170464,170760,296,"W-open-W",170464,170760,"chrVIII"
"chrVIII","YHR032W (ERC1)","+",175474,175482,NA,NA,"-1_missing",175001,175482,"chrVIII"
"chrVIII","YHR032W-A","+",175486,175482,NA,NA,"-1_missing",175001,175482,"chrVIII"
"chrVIII","YHR033W","+",177024,177080,176968,112,"F-overlap-W",176968,177080,"chrVIII"
"chrVIII","YHR034C (PIH1 NOP17)","-",176941,176740,176968,228,"F-open-F",176740,176968,"chrVIII"
"chrVIII","YHR035W","+",180257,180282,180040,242,"W-open-W",180040,180282,"chrVIII"
"chrVIII","YHR036W (BRL1)","+",181972,181963,181689,274,"W-open-F",181689,181963,"chrVIII"
"chrVIII","YHR037W (PUT2)","+",183873,183910,183731,179,"F-close-W",183731,183910,"chrVIII"
"chrVIII","YHR038W (RRF1 FIL1 KIM4)","+",184862,184914,184776,138,"F-close-F",184776,184914,"chrVIII"
"chrVIII","YHR039C (MSC7)","-",184766,184776,184914,138,"F-close-F",184776,184914,"chrVIII"
"chrVIII","YHR039C-A (VMA10 YHR039BC YHR039C-B)","-",187081,186899,187135,236,"F-open-W",186899,187135,"chrVIII"
"chrVIII","YHR040W (BCD1)","+",189097,189204,188967,237,"W-open-F",188967,189204,"chrVIII"
"chrVIII","YHR041C (SRB2 HRS2 MED20)","-",189028,188967,189204,237,"F-open-W",188967,189204,"chrVIII"
"chrVIII","YHR042W (NCP1 CPR1)","+",192721,192799,192535,264,"F-open-F",192535,192799,"chrVIII"
"chrVIII","YHR043C (DOG2)","-",192718,192535,192799,264,"F-open-F",192535,192799,"chrVIII"
"chrVIII","YHR044C (DOG1)","-",193955,193846,194029,183,"F-close-W",193846,194029,"chrVIII"
"chrVIII","YHR045W","+",197323,197376,197172,204,"W-close-W",197172,197376,"chrVIII"
"chrVIII","YHR046C (INM1)","-",197228,197172,197376,204,"W-close-W",197172,197376,"chrVIII"
"chrVIII","YHR047C (AAP1 AAP1')","-",198592,198384,198629,245,"W-open-W",198384,198629,"chrVIII"
"chrVIII","YHR048W (YHK8)","+",206390,206442,206366,76,"F-overlap-W",206366,206442,"chrVIII"
"chrVIII","YHR049W (FSH1)","+",207327,207512,207216,296,"W-open-F",207216,207512,"chrVIII"
"chrVIII","YHR050W (SMF2)","+",209370,209591,209308,283,"F-open-W",209308,209591,"chrVIII"
"chrVIII","YHR050W-A","+",210161,210221,210064,157,"W-close-F",210064,210221,"chrVIII"
"chrVIII","YHR051W (COX6)","+",210440,210563,210370,193,"W-close-W",210370,210563,"chrVIII"
"chrVIII","YHR052W (CIC1 NSA3)","+",212112,212164,212033,131,"F-close-F",212033,212164,"chrVIII"
"chrVIII","YHR052W-A","+",212732,NA,NA,NA,"+1_missing",212267,214245,"chrVIII"
"chrVIII","YHR053C (CUP1-1 CUP1)","-",212360,212267,NA,NA,"-1_missing",212267,214245,"chrVIII"
"chrVIII","YHR054W-A","+",214730,NA,NA,NA,"+1_missing",214245,216207,"chrVIII"
"chrVIII","YHR055C (CUP1-2 CUP1)","-",214357,214245,NA,NA,"-1_missing",214245,216207,"chrVIII"
"chrVIII","YHR056W-A","+",218227,218293,218103,190,"W-close-W",218103,218293,"chrVIII"
"chrVIII","YHR057C (CPR2 CYP2)","-",218148,218103,218293,190,"W-close-W",218103,218293,"chrVIII"
"chrVIII","YHR058C (MED6)","-",218940,218797,219048,251,"W-open-W",218797,219048,"chrVIII"
"chrVIII","YHR059W (FYV4)","+",220601,220607,220436,171,"W-close-F",220436,220607,"chrVIII"
"chrVIII","YHR060W (VMA22 CEV1 VPH6)","+",221349,221469,221287,182,"F-close-W",221287,221469,"chrVIII"
"chrVIII","YHR061C (GIC1)","-",221259,221117,221287,170,"F-close-W",221117,221287,"chrVIII"
"chrVIII","YHR062C (RPP1)","-",222794,222640,222926,286,"W-open-W",222640,222926,"chrVIII"
"chrVIII","YHR063C (PAN5)","-",223953,223725,223977,252,"W-open-W",223725,223977,"chrVIII"
"chrVIII","YHR063W-A","+",225943,226009,225838,171,"F-close-W",225838,226009,"chrVIII"
"chrVIII","YHR064C (SSZ1 PDR13)","-",225419,225373,225579,206,"W-close-W",225373,225579,"chrVIII"
"chrVIII","YHR065C (RRP3)","-",227422,227313,227539,226,"F-open-F",227313,227539,"chrVIII"
"chrVIII","YHR066W (SSF1)","+",230827,230955,230771,184,"W-close-W",230771,230955,"chrVIII"
"chrVIII","YHR067W (HTD2 RMD12)","+",232037,232106,231825,281,"W-open-W",231825,232106,"chrVIII"
"chrVIII","YHR068W (DYS1)","+",233437,233487,233409,78,"F-overlap-W",233409,233487,"chrVIII"
"chrVIII","YHR069C (RRP4)","-",233436,233409,233487,78,"W-overlap-F",233409,233487,"chrVIII"
"chrVIII","YHR070W (TRM5)","+",236728,236761,236663,98,"F-overlap-F",236663,236761,"chrVIII"
"chrVIII","YHR071C-A","-",238852,238831,239055,224,"W-open-W",238831,239055,"chrVIII"
"chrVIII","YHR071W (PCL5)","+",237802,238075,237644,431,"F-open-F",237644,238075,"chrVIII"
"chrVIII","YHR072W (ERG7)","+",241395,241651,241367,284,"W-open-W",241367,241651,"chrVIII"
"chrVIII","YHR072W-A (NOP10)","+",241998,242094,241971,123,"F-close-W",241971,242094,"chrVIII"
"chrVIII","YHR073W (OSH3)","+",245728,245929,245658,271,"W-open-W",245658,245929,"chrVIII"
"chrVIII","YHR074W (QNS1)","+",248470,248514,248299,215,"F-close-W",248299,248514,"chrVIII"
"chrVIII","YHR075C (PPE1 MRPS2)","-",248373,248299,248514,215,"W-close-F",248299,248514,"chrVIII"
"chrVIII","YHR076W (PTC7)","+",252364,252408,252180,228,"F-open-F",252180,252408,"chrVIII"
"chrVIII","YHR077C (NMD2 IFS1 SUA1 SUP111 UPF2)","-",252284,252180,252408,228,"F-open-F",252180,252408,"chrVIII"
"chrVIII","YHR078W","+",258132,258252,258042,210,"W-close-F",258042,258252,"chrVIII"
"chrVIII","YHR079C (IRE1 ERN1)","-",258026,258042,258252,210,"F-close-W",258042,258252,"chrVIII"
"chrVIII","YHR079C-A (SAE3 YHR079BC YHR079C-B)","-",261971,261803,262087,284,"F-open-W",261803,262087,"chrVIII"
"chrVIII","YHR080C","-",262746,262541,262841,300,"F-open-W",262541,262841,"chrVIII"
"chrVIII","YHR081W (LRP1 RRP47 YC1D)","+",268231,268221,268026,195,"F-close-W",268026,268221,"chrVIII"
"chrVIII","YHR082C (KSP1)","-",268244,268221,268397,176,"F-close-W",268221,268397,"chrVIII"
"chrVIII","YHR083W (SAM35 FMP20 TOB38 TOM38)","+",273701,273915,273595,320,"W-open-W",273595,273915,"chrVIII"
"chrVIII","YHR084W (STE12)","+",276538,276531,276343,188,"W-close-F",276343,276531,"chrVIII"
"chrVIII","YHR085W (IPI1)","+",277884,277981,277698,283,"W-open-W",277698,277981,"chrVIII"
"chrVIII","YHR086W (NAM8 MRE2 MUD15)","+",279938,279972,279682,290,"F-open-F",279682,279972,"chrVIII"
"chrVIII","YHR087W (RTC3)","+",281339,281499,281194,305,"W-open-W",281194,281499,"chrVIII"
"chrVIII","YHR088W (RPF1)","+",282475,282710,282447,263,"F-open-F",282447,282710,"chrVIII"
"chrVIII","YHR089C (GAR1)","-",282491,282447,282710,263,"F-open-F",282447,282710,"chrVIII"
"chrVIII","YHR090C (YNG2 EAF4 NBN1)","-",283528,283313,283626,313,"W-open-W",283313,283626,"chrVIII"
"chrVIII","YHR091C (MSR1)","-",284746,284586,284882,296,"W-open-W",284586,284882,"chrVIII"
"chrVIII","YHR092C (HXT4 LGT1 RAG1)","-",286954,286741,286990,249,"F-open-W",286741,286990,"chrVIII"
"chrVIII","YHR094C (HXT1 HOR4)","-",290807,290788,290979,191,"W-close-F",290788,290979,"chrVIII"
"chrVIII","YHR096C (HXT5)","-",294444,294447,294560,113,"F-overlap-F",294447,294560,"chrVIII"
"chrVIII","YHR097C","-",297279,297251,297348,97,"F-overlap-F",297251,297348,"chrVIII"
"chrVIII","YHR098C (SFB3 LST1)","-",299003,298952,299152,200,"W-close-W",298952,299152,"chrVIII"
"chrVIII","YHR099W (TRA1)","+",314121,314179,313977,202,"W-close-W",313977,314179,"chrVIII"
"chrVIII","YHR100C (GEP4)","-",313994,313977,314179,202,"W-close-W",313977,314179,"chrVIII"
"chrVIII","YHR101C (BIG1)","-",314697,314663,314937,274,"W-open-W",314663,314937,"chrVIII"
"chrVIII","YHR102W (KIC1 NRK1)","+",319929,319918,319744,174,"W-close-W",319744,319918,"chrVIII"
"chrVIII","YHR103W (SBE22)","+",323142,323378,323103,275,"W-open-F",323103,323378,"chrVIII"
"chrVIII","YHR104W (GRE3)","+",324559,324729,324506,223,"F-open-W",324506,324729,"chrVIII"
"chrVIII","YHR105W (YPT35)","+",325426,325596,325375,221,"W-open-W",325375,325596,"chrVIII"
"chrVIII","YHR106W (TRR2)","+",326765,326749,326559,190,"W-close-F",326559,326749,"chrVIII"
"chrVIII","YHR107C (CDC12 CLA10 PSL7)","-",326650,326559,326749,190,"F-close-W",326559,326749,"chrVIII"
"chrVIII","YHR108W (GGA2)","+",330197,330341,330127,214,"W-close-W",330127,330341,"chrVIII"
"chrVIII","YHR109W (CTM1)","+",332143,332313,332031,282,"W-open-W",332031,332313,"chrVIII"
"chrVIII","YHR110W (ERP5)","+",333033,333093,332834,259,"W-open-W",332834,333093,"chrVIII"
"chrVIII","YHR111W (UBA4 YHR1)","+",334450,334514,334324,190,"F-close-W",334324,334514,"chrVIII"
"chrVIII","YHR112C","-",334357,334324,334514,190,"W-close-F",334324,334514,"chrVIII"
"chrVIII","YHR113W","+",337947,338047,337778,269,"W-open-W",337778,338047,"chrVIII"
"chrVIII","YHR114W (BZZ1 LSB7)","+",340110,340195,339987,208,"F-close-W",339987,340195,"chrVIII"
"chrVIII","YHR115C (DMA1 CHF1)","-",339981,339987,340195,208,"W-close-F",339987,340195,"chrVIII"
"chrVIII","YHR116W (COX23)","+",342287,342335,342060,275,"W-open-W",342060,342335,"chrVIII"
"chrVIII","YHR117W (TOM71 TOM72)","+",344367,344440,344284,156,"F-close-W",344284,344440,"chrVIII"
"chrVIII","YHR118C (ORC6)","-",344249,344179,344284,105,"F-overlap-F",344179,344284,"chrVIII"
"chrVIII","YHR119W (SET1 YTX1)","+",349426,349567,349390,177,"W-close-W",349390,349567,"chrVIII"
"chrVIII","YHR120W (MSH1)","+",352520,352745,352475,270,"W-open-W",352475,352745,"chrVIII"
"chrVIII","YHR121W (LSM12)","+",353417,353610,353339,271,"W-open-W",353339,353610,"chrVIII"
"chrVIII","YHR122W","+",354478,354563,354400,163,"F-close-W",354400,354563,"chrVIII"
"chrVIII","YHR123W (EPT1)","+",356227,356267,356197,70,"W-overlap-F",356197,356267,"chrVIII"
"chrVIII","YHR124W (NDT80)","+",358481,358716,358354,362,"W-open-W",358354,358716,"chrVIII"
"chrVIII","YHR127W (HSN1)","+",361848,362047,361742,305,"W-open-W",361742,362047,"chrVIII"
"chrVIII","YHR128W (FUR1)","+",362976,363044,362859,185,"W-close-W",362859,363044,"chrVIII"
"chrVIII","YHR129C (ARP1 ACT5)","-",362897,362859,363044,185,"W-close-W",362859,363044,"chrVIII"
"chrVIII","YHR131C","-",365076,364972,365163,191,"F-close-W",364972,365163,"chrVIII"
"chrVIII","YHR132C (ECM14)","-",368383,368337,368544,207,"W-close-W",368337,368544,"chrVIII"
"chrVIII","YHR132W-A (IGO2)","+",370609,370597,370396,201,"W-close-F",370396,370597,"chrVIII"
"chrVIII","YHR133C (NSG1)","-",370640,370597,370737,140,"F-close-F",370597,370737,"chrVIII"
"chrVIII","YHR134W (WSS1)","+",372698,372710,372631,79,"F-overlap-F",372631,372710,"chrVIII"
"chrVIII","YHR135C (YCK1 CKI2)","-",372592,372499,372631,132,"F-close-F",372499,372631,"chrVIII"
"chrVIII","YHR136C (SPL2)","-",374555,374374,374701,327,"W-open-W",374374,374701,"chrVIII"
"chrVIII","YHR137W (ARO9)","+",377364,377357,377162,195,"F-close-F",377162,377357,"chrVIII"
"chrVIII","YHR138C","-",377233,377162,377357,195,"F-close-F",377162,377357,"chrVIII"
"chrVIII","YHR139C (SPS100)","-",377916,377821,378025,204,"W-close-F",377821,378025,"chrVIII"
"chrVIII","YHR140W","+",381379,381568,381258,310,"W-open-W",381258,381568,"chrVIII"
"chrVIII","YHR141C (RPL42B MAK18)","-",381896,381859,382069,210,"W-close-F",381859,382069,"chrVIII"
"chrVIII","YHR142W (CHS7)","+",384565,384604,384408,196,"W-close-W",384408,384604,"chrVIII"
"chrVIII","YHR143W (DSE2)","+",386722,386784,386572,212,"F-close-F",386572,386784,"chrVIII"
"chrVIII","YHR143W-A (RPC10 RPB12)","+",387711,387879,387546,333,"W-open-W",387546,387879,"chrVIII"
"chrVIII","YHR144C (DCD1)","-",387703,387546,387879,333,"W-open-W",387546,387879,"chrVIII"
"chrVIII","YHR146W (CRP1)","+",391752,NA,NA,NA,"+1_missing",391692,392091,"chrVIII"
"chrVIII","YHR147C (MRPL6)","-",392524,392503,392582,79,"F-overlap-W",392503,392582,"chrVIII"
"chrVIII","YHR148W (IMP3)","+",394428,394432,394361,71,"F-overlap-F",394361,394432,"chrVIII"
"chrVIII","YHR149C (SKG6)","-",394310,394227,394361,134,"F-close-W",394227,394361,"chrVIII"
"chrVIII","YHR150W (PEX28)","+",399137,399179,399100,79,"F-overlap-F",399100,399179,"chrVIII"
"chrVIII","YHR151C (MTC6)","-",399131,399100,399179,79,"F-overlap-F",399100,399179,"chrVIII"
"chrVIII","YHR152W (SPO12)","+",402071,402167,401962,205,"F-close-W",401962,402167,"chrVIII"
"chrVIII","YHR153C (SPO16)","-",401928,401845,401962,117,"F-overlap-F",401845,401962,"chrVIII"
"chrVIII","YHR154W (RTT107 ESC4)","+",406260,406276,406084,192,"W-close-F",406084,406276,"chrVIII"
"chrVIII","YHR155W (YSP1)","+",410950,411113,410815,298,"W-open-W",410815,411113,"chrVIII"
"chrVIII","YHR156C (LIN1 SNU40)","-",411349,411297,411473,176,"W-close-F",411297,411473,"chrVIII"
"chrVIII","YHR157W (REC104)","+",413621,413615,413445,170,"W-close-F",413445,413615,"chrVIII"
"chrVIII","YHR158C (KEL1)","-",413546,413445,413615,170,"F-close-W",413445,413615,"chrVIII"
"chrVIII","YHR159W","+",419432,419545,419391,154,"F-close-F",419391,419545,"chrVIII"
"chrVIII","YHR160C (PEX18)","-",419150,419086,419250,164,"W-close-F",419086,419250,"chrVIII"
"chrVIII","YHR161C (YAP1801)","-",420282,420057,420322,265,"F-open-W",420057,420322,"chrVIII"
"chrVIII","YHR162W","+",423577,423745,423452,293,"W-open-W",423452,423745,"chrVIII"
"chrVIII","YHR163W (SOL3)","+",424611,424629,424552,77,"F-overlap-W",424552,424629,"chrVIII"
"chrVIII","YHR164C (DNA2 WEB2)","-",424496,424440,424552,112,"F-overlap-W",424440,424552,"chrVIII"
"chrVIII","YHR165C (PRP8 DBF3 DNA39 RNA8 SLT21 USA2)","-",429614,429496,429669,173,"F-close-W",429496,429669,"chrVIII"
"chrVIII","YHR166C (CDC23)","-",437072,437003,437251,248,"W-open-W",437003,437251,"chrVIII"
"chrVIII","YHR167W (THP2)","+",440244,440355,440148,207,"W-close-W",440148,440355,"chrVIII"
"chrVIII","YHR168W (MTG2)","+",442136,442164,441895,269,"W-open-W",441895,442164,"chrVIII"
"chrVIII","YHR169W (DBP8)","+",443562,443808,443488,320,"W-open-W",443488,443808,"chrVIII"
"chrVIII","YHR170W (NMD3 SRC5)","+",445505,445759,445480,279,"W-open-W",445480,445759,"chrVIII"
"chrVIII","YHR171W (ATG7 APG11 APG7 CVT2)","+",447721,447821,447620,201,"W-close-F",447620,447821,"chrVIII"
"chrVIII","YHR172W (SPC97)","+",451233,451219,451042,177,"W-close-F",451042,451219,"chrVIII"
"chrVIII","YHR173C","-",450457,450317,450512,195,"W-close-W",450317,450512,"chrVIII"
"chrVIII","YHR174W (ENO2)","+",452765,452956,452643,313,"W-open-W",452643,452956,"chrVIII"
"chrVIII","YHR175W-A","+",453815,453898,453731,167,"W-close-W",453731,453898,"chrVIII"
"chrVIII","YHR176W (FMO1)","+",455639,NA,NA,NA,"+1_missing",455544,456019,"chrVIII"
"chrVIII","YHR177W (GON3)","+",459097,459290,458983,307,"W-open-W",458983,459290,"chrVIII"
"chrVIII","YHR178W (STB5)","+",461712,461736,461460,276,"W-open-F",461460,461736,"chrVIII"
"chrVIII","YHR179W (OYE2)","+",463807,463853,463642,211,"F-close-W",463642,463853,"chrVIII"
"chrVIII","YHR180C-B","-",466293,466163,466341,178,"W-close-F",466163,466341,"chrVIII"
"chrVIII","YHR180W","+",465813,465819,465682,137,"F-close-F",465682,465819,"chrVIII"
"chrVIII","YHR181W (SVP26 ERV26)","+",468009,468055,467852,203,"W-close-W",467852,468055,"chrVIII"
"chrVIII","YHR182C-A","-",470852,470851,470969,118,"F-overlap-W",470851,470969,"chrVIII"
"chrVIII","YHR182W","+",470623,470685,470593,92,"W-overlap-F",470593,470685,"chrVIII"
"chrVIII","YHR183W (GND1)","+",472564,472765,472343,422,"W-open-W",472343,472765,"chrVIII"
"chrVIII","YHR184W (SSP1 SPO3)","+",474589,474603,474425,178,"W-close-F",474425,474603,"chrVIII"
"chrVIII","YHR185C (PFS1 ADY1)","-",474498,474425,474603,178,"F-close-W",474425,474603,"chrVIII"
"chrVIII","YHR186C (KOG1 LAS24)","-",475887,475679,476096,417,"W-open-F",475679,476096,"chrVIII"
"chrVIII","YHR187W (IKI1 ELP5 HAP2 TOT5)","+",482029,482142,481983,159,"W-close-F",481983,482142,"chrVIII"
"chrVIII","YHR188C (GPI16)","-",481933,481839,481983,144,"W-close-W",481839,481983,"chrVIII"
"chrVIII","YHR189W (PTH1 PTH)","+",484799,484842,484573,269,"W-open-W",484573,484842,"chrVIII"
"chrVIII","YHR190W (ERG9)","+",486283,486274,486086,188,"W-close-W",486086,486274,"chrVIII"
"chrVIII","YHR191C (CTF8)","-",486119,486086,486274,188,"W-close-W",486086,486274,"chrVIII"
"chrVIII","YHR192W","+",487742,487881,487694,187,"W-close-W",487694,487881,"chrVIII"
"chrVIII","YHR193C (EGD2)","-",487648,487528,487694,166,"W-close-W",487528,487694,"chrVIII"
"chrVIII","YHR193C-A","-",488446,488217,488642,425,"W-open-W",488217,488642,"chrVIII"
"chrVIII","YHR194W (MDM31)","+",490485,490640,490363,277,"W-open-W",490363,490640,"chrVIII"
"chrVIII","YHR195W (NVJ1 VAB36)","+",491881,491926,491632,294,"W-open-W",491632,491926,"chrVIII"
"chrVIII","YHR196W (UTP9)","+",493709,493916,493622,294,"W-open-W",493622,493916,"chrVIII"
"chrVIII","YHR197W (RIX1 IPI2)","+",496292,496324,496253,71,"F-overlap-W",496253,496324,"chrVIII"
"chrVIII","YHR198C (AIM18 FMP22)","-",496194,496128,496253,125,"F-close-F",496128,496253,"chrVIII"
"chrVIII","YHR199C (AIM46 FMP34)","-",497399,497243,497488,245,"F-open-W",497243,497488,"chrVIII"
"chrVIII","YHR199C-A (NBL1 MCL1)","-",498178,498133,498281,148,"W-close-W",498133,498281,"chrVIII"
"chrVIII","YHR200W (RPN10 MCB1 SUN1)","+",499955,499987,499748,239,"F-open-F",499748,499987,"chrVIII"
"chrVIII","YHR201C (PPX1)","-",499874,499748,499987,239,"F-open-F",499748,499987,"chrVIII"
"chrVIII","YHR202W","+",504258,504253,504098,155,"F-close-F",504098,504253,"chrVIII"
"chrVIII","YHR203C (RPS4B)","-",504349,504253,504411,158,"F-close-F",504253,504411,"chrVIII"
"chrVIII","YHR204W (MNL1 HTM1)","+",508790,508955,508650,305,"W-open-W",508650,508955,"chrVIII"
"chrVIII","YHR205W (SCH9 HRM2 KOM1)","+",512048,512065,511828,237,"W-open-W",511828,512065,"chrVIII"
"chrVIII","YHR206W (SKN7 BRY1 POS9)","+",514718,514750,514578,172,"F-close-F",514578,514750,"chrVIII"
"chrVIII","YHR207C (SET5)","-",514891,514750,514941,191,"W-close-F",514750,514941,"chrVIII"
"chrVIII","YHR208W (BAT1 ECA39 TWT1)","+",518865,518866,518699,167,"F-close-F",518699,518866,"chrVIII"
"chrVIII","YHR209W (CRG1)","+",520401,520467,520257,210,"F-close-F",520257,520467,"chrVIII"
"chrVIII","YHR210C","-",520531,520467,520664,197,"W-close-F",520467,520664,"chrVIII"
"chrVIII","YHR215W (PHO12 PHO10)","+",553568,553553,NA,NA,"-1_missing",551412,553553,"chrVIII"
"chrVIII","YHR216W (IMD2 PUR5)","+",556152,556284,556014,270,"W-open-W",556014,556284,"chrVIII"
"chrX","YJL001W (PRE3 CRL21)","+",436051,436184,436000,184,"W-close-W",436000,436184,"chrX"
"chrX","YJL002C (OST1 NLT1)","-",433110,432966,433156,190,"F-close-W",432966,433156,"chrX"
"chrX","YJL003W (COX16)","+",433199,433303,433156,147,"F-close-F",433156,433303,"chrX"
"chrX","YJL004C (SYS1)","-",431327,431286,431435,149,"F-close-F",431286,431435,"chrX"
"chrX","YJL005W (CYR1 CDC35 FIL1 HSR1 SRA4 TSM0185)","+",431393,431435,431286,149,"F-close-F",431286,431435,"chrX"
"chrX","YJL006C (CTK2)","-",423085,NA,NA,NA,"+1_missing",422778,423135,"chrX"
"chrX","YJL008C (CCT8)","-",419802,419811,420001,190,"W-close-W",419811,420001,"chrX"
"chrX","YJL009W","+",420283,420301,420159,142,"F-close-F",420159,420301,"chrX"
"chrX","YJL010C (NOP9)","-",417479,417225,417523,298,"F-open-W",417225,417523,"chrX"
"chrX","YJL011C (RPC17)","-",414121,413996,414230,234,"F-open-F",413996,414230,"chrX"
"chrX","YJL012C (VTC4 PHM3 YJL012C-A)","-",411163,410971,411240,269,"F-open-W",410971,411240,"chrX"
"chrX","YJL013C (MAD3)","-",409336,409332,409494,162,"W-close-F",409332,409494,"chrX"
"chrX","YJL014W (CCT3 BIN2 TCP3)","+",409294,409332,409246,86,"F-overlap-F",409246,409332,"chrX"
"chrX","YJL016W (YJL017W)","+",407389,407570,407283,287,"W-open-W",407283,407570,"chrX"
"chrX","YJL019W (MPS3 NEP98 YJL018W)","+",405476,405555,405348,207,"W-close-F",405348,405555,"chrX"
"chrX","YJL020C (BBC1 MTI1 YJL021C)","-",398788,398749,398932,183,"W-close-F",398749,398932,"chrX"
"chrX","YJL022W","+",398878,398932,398749,183,"F-close-W",398749,398932,"chrX"
"chrX","YJL023C (PET130)","-",397275,397144,397304,160,"W-close-W",397144,397304,"chrX"
"chrX","YJL024C (APS3 YKS7)","-",395698,395561,395745,184,"W-close-W",395561,395745,"chrX"
"chrX","YJL025W (RRN7)","+",395657,395745,395561,184,"W-close-W",395561,395745,"chrX"
"chrX","YJL026C-A","-",392748,392605,392773,168,"F-close-W",392605,392773,"chrX"
"chrX","YJL026W (RNR2 CRT6)","+",393744,393964,393629,335,"F-open-W",393629,393964,"chrX"
"chrX","YJL027C","-",391772,391706,391803,97,"F-overlap-F",391706,391803,"chrX"
"chrX","YJL029C (VPS53)","-",388285,388180,388355,175,"W-close-W",388180,388355,"chrX"
"chrX","YJL030W (MAD2)","+",388386,388525,388355,170,"W-close-W",388355,388525,"chrX"
"chrX","YJL031C (BET4)","-",386257,386261,386434,173,"W-close-F",386261,386434,"chrX"
"chrX","YJL033W (HCA4 DBP4 ECM24)","+",386230,386261,386189,72,"F-overlap-F",386189,386261,"chrX"
"chrX","YJL034W (KAR2 GRP78)","+",383582,383849,383555,294,"F-open-W",383555,383849,"chrX"
"chrX","YJL035C (TAD2)","-",380160,380115,380312,197,"W-close-F",380115,380312,"chrX"
"chrX","YJL036W (SNX4 ATG24 CVT13)","+",380250,380312,380115,197,"F-close-W",380115,380312,"chrX"
"chrX","YJL037W (IRC18)","+",377442,377505,377402,103,"F-overlap-F",377402,377505,"chrX"
"chrX","YJL038C (LOH1 OSW4)","-",374993,374862,375151,289,"F-open-F",374862,375151,"chrX"
"chrX","YJL039C (NUP192)","-",368390,368314,368467,153,"F-close-F",368314,368467,"chrX"
"chrX","YJL041W (NSP1)","+",368505,368572,368467,105,"F-overlap-F",368467,368572,"chrX"
"chrX","YJL042W (MHP1)","+",365600,365764,365472,292,"W-open-W",365472,365764,"chrX"
"chrX","YJL043W","+",361239,361328,361162,166,"F-close-W",361162,361328,"chrX"
"chrX","YJL044C (GYP6)","-",358039,358029,358110,81,"F-overlap-F",358029,358110,"chrX"
"chrX","YJL045W (SDH1b)","+",358124,358110,358029,81,"F-overlap-F",358029,358110,"chrX"
"chrX","YJL046W (AIM22 LIP3 RRG3)","+",353682,353747,353577,170,"W-close-W",353577,353747,"chrX"
"chrX","YJL047C (RTT101 CUL8 CULC)","-",349501,349342,349602,260,"F-open-W",349342,349602,"chrX"
"chrX","YJL047C-A","-",348697,348566,348741,175,"F-close-W",348566,348741,"chrX"
"chrX","YJL048C (UBX6 CUI2)","-",347307,347268,347495,227,"F-open-F",347268,347495,"chrX"
"chrX","YJL049W","+",347402,347495,347268,227,"F-open-F",347268,347495,"chrX"
"chrX","YJL050W (MTR4 DOB1)","+",345802,345993,345715,278,"W-open-W",345715,345993,"chrX"
"chrX","YJL051W (IRC8)","+",342465,342508,342209,299,"W-open-W",342209,342508,"chrX"
"chrX","YJL052W (TDH1 GLD3)","+",339398,339648,339372,276,"F-open-W",339372,339648,"chrX"
"chrX","YJL053W (PEP8 GRD6 VPS26 VPT4)","+",337204,337259,337160,99,"F-overlap-F",337160,337259,"chrX"
"chrX","YJL054W (TIM54)","+",335780,335904,335625,279,"W-open-F",335625,335904,"chrX"
"chrX","YJL055W","+",334155,334306,334045,261,"W-open-W",334045,334306,"chrX"
"chrX","YJL056C (ZAP1 ZRG10)","-",330307,330174,330356,182,"F-close-W",330174,330356,"chrX"
"chrX","YJL057C (IKS1)","-",328036,327870,328081,211,"F-close-W",327870,328081,"chrX"
"chrX","YJL058C (BIT61)","-",326200,326118,326347,229,"F-open-F",326118,326347,"chrX"
"chrX","YJL059W (YHC3 BTN1)","+",326274,326347,326118,229,"F-open-F",326118,326347,"chrX"
"chrX","YJL060W (BNA3)","+",324817,324976,324735,241,"F-open-W",324735,324976,"chrX"
"chrX","YJL061W (NUP82 HRB187)","+",322332,322329,322260,69,"F-overlap-F",322260,322329,"chrX"
"chrX","YJL062W (LAS21 GPI7)","+",319869,320028,319738,290,"W-open-W",319738,320028,"chrX"
"chrX","YJL062W-A (COA3 COX25 RRG10)","+",317164,317279,317068,211,"F-close-W",317068,317279,"chrX"
"chrX","YJL063C (MRPL8 HRD238)","-",315680,315541,315800,259,"W-open-W",315541,315800,"chrX"
"chrX","YJL065C (DLS1)","-",314939,314843,315083,240,"W-open-W",314843,315083,"chrX"
"chrX","YJL066C (MPM1)","-",313919,313910,313984,74,"F-overlap-W",313910,313984,"chrX"
"chrX","YJL068C","-",312913,312686,312974,288,"W-open-W",312686,312974,"chrX"
"chrX","YJL069C (UTP18)","-",310840,310624,310898,274,"W-open-F",310624,310898,"chrX"
"chrX","YJL070C","-",307889,307786,307951,165,"F-close-F",307786,307951,"chrX"
"chrX","YJL071W (ARG2 HRB574)","+",307975,308039,307951,88,"F-overlap-F",307951,308039,"chrX"
"chrX","YJL072C (PSF2 CDC102)","-",305069,305044,305149,105,"F-overlap-W",305044,305149,"chrX"
"chrX","YJL073W (JEM1 KAR8)","+",305205,305339,305149,190,"F-close-W",305149,305339,"chrX"
"chrX","YJL074C (SMC3)","-",299071,298942,299161,219,"F-open-F",298942,299161,"chrX"
"chrX","YJL076W (NET1 CFI1 ESC5 SRM8)","+",298952,298942,298822,120,"F-close-F",298822,298942,"chrX"
"chrX","YJL077C (ICS3)","-",294097,293957,294132,175,"W-close-W",293957,294132,"chrX"
"chrX","YJL077W-A","+",295047,295060,294863,197,"W-close-F",294863,295060,"chrX"
"chrX","YJL077W-B","+",294320,294317,294132,185,"W-close-F",294132,294317,"chrX"
"chrX","YJL078C (PRY3)","-",291000,290881,291087,206,"F-close-W",290881,291087,"chrX"
"chrX","YJL079C (PRY1)","-",289691,289687,289878,191,"W-close-W",289687,289878,"chrX"
"chrX","YJL080C (SCP160)","-",285437,285249,285489,240,"W-open-W",285249,285489,"chrX"
"chrX","YJL081C (ARP4 ACT3)","-",283654,283574,283708,134,"F-close-F",283574,283708,"chrX"
"chrX","YJL082W (IML2)","+",283598,283708,283574,134,"F-close-F",283574,283708,"chrX"
"chrX","YJL083W (TAX4)","+",281032,281151,280971,180,"W-close-F",280971,281151,"chrX"
"chrX","YJL084C (ALY2 ART3)","-",274717,274688,274880,192,"W-close-F",274688,274880,"chrX"
"chrX","YJL085W (EXO70)","+",274809,274880,274688,192,"F-close-W",274688,274880,"chrX"
"chrX","YJL087C (TRL1 LIG1 RLG1)","-",269787,269759,269868,109,"F-overlap-F",269759,269868,"chrX"
"chrX","YJL088W (ARG3 argF)","+",269895,269997,269868,129,"F-close-F",269868,269997,"chrX"
"chrX","YJL089W (SIP4)","+",268673,268822,268405,417,"W-open-F",268405,268822,"chrX"
"chrX","YJL090C (DPB11)","-",262679,262505,262773,268,"W-open-W",262505,262773,"chrX"
"chrX","YJL091C (GWT1)","-",260927,260903,261043,140,"F-close-F",260903,261043,"chrX"
"chrX","YJL092W (SRS2 HPR5 RADH RADH1)","+",261050,261043,260903,140,"F-close-F",260903,261043,"chrX"
"chrX","YJL093C (TOK1 DUK1 YKC1 YORK YPK1)","-",254611,254443,254674,231,"F-open-W",254443,254674,"chrX"
"chrX","YJL094C (KHA1)","-",251676,251655,251723,68,"F-overlap-F",251655,251723,"chrX"
"chrX","YJL095W (BCK1 LAS3 SAP3 SLK1 SSP31)","+",251763,251918,251723,195,"F-close-F",251723,251918,"chrX"
"chrX","YJL096W (MRPL49)","+",247046,247225,246955,270,"F-open-W",246955,247225,"chrX"
"chrX","YJL097W (PHS1)","+",246317,246482,246216,266,"W-open-W",246216,246482,"chrX"
"chrX","YJL098W (SAP185)","+",245336,245404,245185,219,"W-open-W",245185,245404,"chrX"
"chrX","YJL099W (CHS6 CSD3)","+",241995,242107,241896,211,"W-close-W",241896,242107,"chrX"
"chrX","YJL100W (LSB6)","+",239167,239383,239117,266,"W-open-W",239117,239383,"chrX"
"chrX","YJL101C (GSH1)","-",234166,234137,234318,181,"F-close-W",234137,234318,"chrX"
"chrX","YJL102W (MEF2)","+",233875,233947,233785,162,"W-close-F",233785,233947,"chrX"
"chrX","YJL103C (GSM1)","-",228831,228746,229001,255,"F-open-W",228746,229001,"chrX"
"chrX","YJL104W (PAM16 MIA1 TIM16)","+",227944,228039,227824,215,"W-close-F",227824,228039,"chrX"
"chrX","YJL106W (IME2 SME1)","+",223466,223493,223310,183,"W-close-W",223310,223493,"chrX"
"chrX","YJL109C (UTP10)","-",211941,211946,212104,158,"W-close-F",211946,212104,"chrX"
"chrX","YJL110C (GZF3 DEH1 NIL2)","-",209814,209787,209997,210,"F-close-F",209787,209997,"chrX"
"chrX","YJL111W (CCT7 TCP7)","+",209700,209787,209645,142,"F-close-F",209645,209787,"chrX"
"chrX","YJL112W (MDV1 FIS2 GAG3 NET2)","+",207600,207875,207559,316,"W-open-W",207559,207875,"chrX"
"chrX","YJL115W (ASF1 CIA1)","+",197228,NA,NA,NA,"+1_missing",197201,197547,"chrX"
"chrX","YJL116C (NCA3)","-",193546,193486,193675,189,"W-close-W",193486,193675,"chrX"
"chrX","YJL117W (PHO86)","+",193623,193675,193486,189,"W-close-W",193486,193675,"chrX"
"chrX","YJL118W","+",192472,192492,192217,275,"W-open-W",192217,192492,"chrX"
"chrX","YJL119C","-",191161,191058,191291,233,"F-open-W",191058,191291,"chrX"
"chrX","YJL121C (RPE1 EPI1 POS18)","-",190296,190238,190416,178,"W-close-W",190238,190416,"chrX"
"chrX","YJL122W (ALB1)","+",190371,190416,190238,178,"W-close-W",190238,190416,"chrX"
"chrX","YJL123C (MTC1)","-",187927,187772,188051,279,"W-open-W",187772,188051,"chrX"
"chrX","YJL124C (LSM1 SPB8)","-",186926,186677,186950,273,"W-open-W",186677,186950,"chrX"
"chrX","YJL125C (GCD14 TRM61)","-",185437,185335,185511,176,"F-close-W",185335,185511,"chrX"
"chrX","YJL126W (NIT2)","+",185545,185592,185511,81,"F-overlap-F",185511,185592,"chrX"
"chrX","YJL127C (SPT10 CRE1 SUD1)","-",181823,181749,181987,238,"F-open-W",181749,181987,"chrX"
"chrX","YJL127C-B (YJL127C-A)","-",181295,181183,181419,236,"W-open-F",181183,181419,"chrX"
"chrX","YJL128C (PBS2 HOG4 SFS4 SSK4)","-",178036,178031,178195,164,"W-close-W",178031,178195,"chrX"
"chrX","YJL129C (TRK1)","-",173529,NA,NA,NA,"+1_missing",173056,173599,"chrX"
"chrX","YJL130C (URA2)","-",165623,165573,165769,196,"W-close-W",165573,165769,"chrX"
"chrX","YJL131C (AIM23)","-",164181,164178,164352,174,"W-close-W",164178,164352,"chrX"
"chrX","YJL132W","+",164286,164352,164178,174,"W-close-W",164178,164352,"chrX"
"chrX","YJL133C-A","-",159453,159433,159617,184,"W-close-F",159433,159617,"chrX"
"chrX","YJL133W (MRS3)","+",161703,161922,161665,257,"W-open-W",161665,161922,"chrX"
"chrX","YJL134W (LCB3 LBP1 YSR2)","+",159471,159617,159433,184,"F-close-W",159433,159617,"chrX"
"chrX","YJL136C (RPS21B)","-",156411,156364,156573,209,"W-close-F",156364,156573,"chrX"
"chrX","YJL137C (GLG2)","-",154862,154867,155023,156,"W-close-F",154867,155023,"chrX"
"chrX","YJL138C (TIF2)","-",153300,153238,153492,254,"F-open-W",153238,153492,"chrX"
"chrX","YJL139C (YUR1)","-",151576,151545,151727,182,"F-close-W",151545,151727,"chrX"
"chrX","YJL140W (RPB4 CTF15)","+",151691,151727,151545,182,"W-close-F",151545,151727,"chrX"
"chrX","YJL141C (YAK1)","-",147847,147749,147992,243,"F-open-W",147749,147992,"chrX"
"chrX","YJL143W (TIM17 MIM17 MPI2 SMS1)","+",147842,147992,147749,243,"W-open-F",147749,147992,"chrX"
"chrX","YJL144W","+",146905,146950,146815,135,"F-close-F",146815,146950,"chrX"
"chrX","YJL145W (SFH5)","+",146127,146160,146039,121,"W-close-F",146039,146160,"chrX"
"chrX","YJL146W (IDS2)","+",144938,145139,144871,268,"W-open-W",144871,145139,"chrX"
"chrX","YJL147C","-",141248,141077,141274,197,"F-close-W",141077,141274,"chrX"
"chrX","YJL148W (RPA34)","+",141336,141426,141274,152,"F-close-F",141274,141426,"chrX"
"chrX","YJL149W (DAS1)","+",139428,139478,139404,74,"F-overlap-F",139404,139478,"chrX"
"chrX","YJL151C (SNA3)","-",136299,136255,136447,192,"F-close-W",136255,136447,"chrX"
"chrX","YJL153C (INO1 APR1)","-",134193,133960,134262,302,"W-open-W",133960,134262,"chrX"
"chrX","YJL154C (VPS35 GRD9 VPT7)","-",131049,131019,131196,177,"W-close-F",131019,131196,"chrX"
"chrX","YJL155C (FBP26)","-",129118,128961,129244,283,"W-open-W",128961,129244,"chrX"
"chrX","YJL156C (SSY5)","-",126463,126431,126745,314,"W-open-F",126431,126745,"chrX"
"chrX","YJL158C (CIS3 CCW11 CCW5 PIR4)","-",122086,121820,122243,423,"F-open-F",121820,122243,"chrX"
"chrX","YJL159W (HSP150 CCW7 ORE1 PIR2)","+",122004,122243,121820,423,"F-open-F",121820,122243,"chrX"
"chrX","YJL160C","-",117843,117759,117916,157,"F-close-F",117759,117916,"chrX"
"chrX","YJL161W (FMP33)","+",117941,117999,117916,83,"F-overlap-F",117916,117999,"chrX"
"chrX","YJL162C (JJJ2)","-",113765,113626,113873,247,"W-open-W",113626,113873,"chrX"
"chrX","YJL163C","-",111607,111331,111631,300,"W-open-W",111331,111631,"chrX"
"chrX","YJL164C (TPK1 PKA1 SRA3)","-",109854,109825,110021,196,"W-close-W",109825,110021,"chrX"
"chrX","YJL165C (HAL5)","-",106866,106737,106970,233,"F-open-W",106737,106970,"chrX"
"chrX","YJL166W (QCR8 COR5)","+",106881,106970,106737,233,"W-open-F",106737,106970,"chrX"
"chrX","YJL167W (ERG20 BOT3 FDS1 FPP1)","+",106187,106237,106047,190,"W-close-F",106047,106237,"chrX"
"chrX","YJL168C (SET2 EZL1)","-",102027,101818,102050,232,"W-open-F",101818,102050,"chrX"
"chrX","YJL170C (ASG7)","-",101123,100874,101179,305,"W-open-W",100874,101179,"chrX"
"chrX","YJL171C","-",99534,99424,99728,304,"F-open-W",99424,99728,"chrX"
"chrX","YJL172W (CPS1)","+",99604,99728,99424,304,"W-open-F",99424,99728,"chrX"
"chrX","YJL173C (RFA3 RPA3)","-",96084,96006,96171,165,"W-close-F",96006,96171,"chrX"
"chrX","YJL174W (KRE9)","+",96104,96171,96006,165,"F-close-W",96006,96171,"chrX"
"chrX","YJL176C (SWI3 TYE2)","-",91826,91708,91867,159,"F-close-F",91708,91867,"chrX"
"chrX","YJL177W (RPL17B)","+",91762,91867,91708,159,"F-close-F",91708,91867,"chrX"
"chrX","YJL178C (ATG27 ETF1)","-",89174,89091,89283,192,"W-close-F",89091,89283,"chrX"
"chrX","YJL179W (PFD1 GIM6)","+",89249,89283,89091,192,"F-close-W",89091,89283,"chrX"
"chrX","YJL180C (ATP12)","-",87481,87485,87572,87,"F-overlap-F",87485,87572,"chrX"
"chrX","YJL181W","+",87579,87572,87485,87,"F-overlap-F",87485,87572,"chrX"
"chrX","YJL183W (MNN11)","+",85425,85658,85375,283,"W-open-W",85375,85658,"chrX"
"chrX","YJL184W (GON7 LDB6 PCC2)","+",83895,84043,83777,266,"W-open-W",83777,84043,"chrX"
"chrX","YJL185C","-",81917,81842,82118,276,"F-open-F",81842,82118,"chrX"
"chrX","YJL186W (MNN5)","+",82033,82118,81842,276,"F-open-F",81842,82118,"chrX"
"chrX","YJL187C (SWE1 WEE1)","-",76700,76612,76732,120,"F-close-F",76612,76732,"chrX"
"chrX","YJL188C (BUD19)","-",75842,NA,NA,NA,"+1_missing",75313,75952,"chrX"
"chrX","YJL189W (RPL39 PUB2 RPL46 SPB2)","+",76655,76732,76612,120,"F-close-F",76612,76732,"chrX"
"chrX","YJL190C (RPS22A RPS24)","-",74769,74786,74988,202,"W-close-F",74786,74988,"chrX"
"chrX","YJL191W (RPS14B CRY2)","+",74716,74786,74687,99,"F-overlap-F",74687,74786,"chrX"
"chrX","YJL192C (SOP4)","-",72603,72529,72719,190,"F-close-W",72529,72719,"chrX"
"chrX","YJL193W","+",72695,72719,72529,190,"W-close-F",72529,72719,"chrX"
"chrX","YJL194W (CDC6)","+",71012,71149,70978,171,"W-close-W",70978,71149,"chrX"
"chrX","YJL196C (ELO1)","-",67715,67558,67821,263,"F-open-W",67558,67821,"chrX"
"chrX","YJL197W (UBP12)","+",67644,67821,67558,263,"W-open-F",67558,67821,"chrX"
"chrX","YJL198W (PHO90)","+",63579,63806,63537,269,"W-open-W",63537,63806,"chrX"
"chrX","YJL199C (MBB1)","-",59630,59645,59798,153,"W-close-W",59645,59798,"chrX"
"chrX","YJL200C (ACO2)","-",56297,56288,56405,117,"F-overlap-F",56288,56405,"chrX"
"chrX","YJL201W (ECM25)","+",56246,56288,56211,77,"F-overlap-F",56211,56288,"chrX"
"chrX","YJL203W (PRP21 SPP91)","+",54288,54420,54161,259,"W-open-W",54161,54420,"chrX"
"chrX","YJL204C (RCY1)","-",50557,50422,50638,216,"W-open-W",50422,50638,"chrX"
"chrX","YJL205C (NCE101 NCE1 YJL205C-A YJL206C-A)","-",50021,49883,50074,191,"W-close-W",49883,50074,"chrX"
"chrX","YJL206C","-",47572,47397,47602,205,"F-close-W",47397,47602,"chrX"
"chrX","YJL207C (LAA1)","-",41347,41198,41486,288,"W-open-W",41198,41486,"chrX"
"chrX","YJL208C (NUC1)","-",40080,40003,40237,234,"F-open-F",40003,40237,"chrX"
"chrX","YJL209W (CBP1)","+",40062,40237,40003,234,"F-open-F",40003,40237,"chrX"
"chrX","YJL210W (PEX2 CRT1 PAS5)","+",37797,37966,37685,281,"W-open-W",37685,37966,"chrX"
"chrX","YJL211C","-",36730,36461,36759,298,"W-open-W",36461,36759,"chrX"
"chrX","YJL212C (OPT1 GSH11 HGT1)","-",33687,33647,33833,186,"W-close-W",33647,33833,"chrX"
"chrX","YJL213W","+",33342,33443,33255,188,"W-close-F",33255,33443,"chrX"
"chrX","YJL216C (IMA5)","-",24142,24098,24276,178,"F-close-F",24098,24276,"chrX"
"chrX","YJL217W (REE1)","+",23842,23834,23756,78,"F-overlap-F",23756,23834,"chrX"
"chrX","YJL218W","+",22709,22719,22554,165,"W-close-W",22554,22719,"chrX"
"chrX","YJR001W (AVT1)","+",438721,438887,438568,319,"W-open-W",438568,438887,"chrX"
"chrX","YJR002W (MPP10)","+",441001,440992,440819,173,"W-close-W",440819,440992,"chrX"
"chrX","YJR003C","-",440907,440819,440992,173,"W-close-W",440819,440992,"chrX"
"chrX","YJR004C (SAG1 AG(ALPHA)1)","-",442765,442527,442855,328,"F-open-W",442527,442855,"chrX"
"chrX","YJR005C-A","-",448163,448056,448265,209,"F-close-F",448056,448265,"chrX"
"chrX","YJR005W (APL1 YAP80)","+",448212,448265,448056,209,"F-close-F",448056,448265,"chrX"
"chrX","YJR006W (POL31 HUS2 HYS2 SDP5)","+",450741,450954,450646,308,"W-open-W",450646,450954,"chrX"
"chrX","YJR007W (SUI2)","+",452061,452091,451903,188,"F-close-W",451903,452091,"chrX"
"chrX","YJR008W","+",453546,453576,453504,72,"F-overlap-F",453504,453576,"chrX"
"chrX","YJR009C (TDH2 GLD2)","-",453550,453504,453576,72,"F-overlap-F",453504,453576,"chrX"
"chrX","YJR010C-A (SPC1)","-",457839,457804,458010,206,"W-close-W",457804,458010,"chrX"
"chrX","YJR010W (MET3)","+",457903,458010,457804,206,"W-close-W",457804,458010,"chrX"
"chrX","YJR011C","-",458550,458359,458609,250,"W-open-W",458359,458609,"chrX"
"chrX","YJR013W (GPI14 PMH1)","+",461687,461837,461550,287,"W-open-W",461550,461837,"chrX"
"chrX","YJR014W (TMA22 RBF22)","+",462607,462718,462522,196,"W-close-W",462522,462718,"chrX"
"chrX","YJR015W","+",464343,464438,464216,222,"F-open-F",464216,464438,"chrX"
"chrX","YJR016C (ILV3)","-",464311,464216,464438,222,"F-open-F",464216,464438,"chrX"
"chrX","YJR017C (ESS1 PIN1 PTF1)","-",466279,466237,466568,331,"W-open-W",466237,466568,"chrX"
"chrX","YJR018W","+",467274,467282,467017,265,"W-open-W",467017,467282,"chrX"
"chrX","YJR019C (TES1 PTE1)","-",467157,467017,467282,265,"W-open-W",467017,467282,"chrX"
"chrX","YJR020W","+",468644,468696,468518,178,"W-close-W",468518,468696,"chrX"
"chrX","YJR021C (REC107 MER2)","-",468457,468265,468518,253,"W-open-W",468265,468518,"chrX"
"chrX","YJR022W (LSM8)","+",470146,470294,469974,320,"W-open-W",469974,470294,"chrX"
"chrX","YJR024C (MDE1)","-",470147,469974,470294,320,"W-open-W",469974,470294,"chrX"
"chrX","YJR025C (BNA1 HAD1)","-",470986,470928,471134,206,"W-close-W",470928,471134,"chrX"
"chrX","YJR030C","-",483864,NA,NA,NA,"+1_missing",477678,483985,"chrX"
"chrX","YJR031C (GEA1)","-",486453,NA,NA,NA,"+1_missing",486106,486693,"chrX"
"chrX","YJR032W (CPR7)","+",492383,492476,492313,163,"F-close-W",492313,492476,"chrX"
"chrX","YJR033C (RAV1 SOI3)","-",492259,492123,492313,190,"F-close-F",492123,492313,"chrX"
"chrX","YJR034W (PET191)","+",497148,497185,496979,206,"W-close-F",496979,497185,"chrX"
"chrX","YJR035W (RAD26)","+",500761,500879,500680,199,"F-close-F",500680,500879,"chrX"
"chrX","YJR036C (HUL4)","-",500604,500529,500680,151,"F-close-F",500529,500680,"chrX"
"chrX","YJR039W","+",507397,507493,507308,185,"W-close-W",507308,507493,"chrX"
"chrX","YJR040W (GEF1 CLC)","+",510154,510210,509994,216,"F-open-F",509994,510210,"chrX"
"chrX","YJR041C (URB2 NPA2)","-",510065,509994,510210,216,"F-open-F",509994,510210,"chrX"
"chrX","YJR042W (NUP85 RAT9)","+",516414,516496,516130,366,"F-open-F",516130,516496,"chrX"
"chrX","YJR043C (POL32)","-",516323,516130,516496,366,"F-open-F",516130,516496,"chrX"
"chrX","YJR044C (VPS55)","-",518586,518538,518702,164,"W-close-W",518538,518702,"chrX"
"chrX","YJR045C (SSC1 ENS1 mtHSP70)","-",519419,519186,519472,286,"F-open-W",519186,519472,"chrX"
"chrX","YJR046W (TAH11 CDT1 SID2)","+",523904,524058,523855,203,"F-close-F",523855,524058,"chrX"
"chrX","YJR047C (ANB1 HYP1 TIF51B eIF-5A)","-",524798,524500,525009,509,"W-open-W",524500,525009,"chrX"
"chrX","YJR048W (CYC1)","+",526847,526879,526718,161,"W-close-W",526718,526879,"chrX"
"chrX","YJR049C (UTR1)","-",526745,526718,526879,161,"W-close-W",526718,526879,"chrX"
"chrX","YJR050W (ISY1 NTC30 UTR3)","+",529679,529849,529625,224,"W-open-W",529625,529849,"chrX"
"chrX","YJR051W (OSM1 FRDS2)","+",531445,531528,531311,217,"W-open-W",531311,531528,"chrX"
"chrX","YJR052W (RAD7)","+",533825,534019,533739,280,"F-open-W",533739,534019,"chrX"
"chrX","YJR054W","+",537652,537896,537535,361,"W-open-F",537535,537896,"chrX"
"chrX","YJR055W (HIT1)","+",539673,539807,NA,NA,"-1_missing",539117,539807,"chrX"
"chrX","YJR056C","-",541660,NA,NA,NA,"+1_missing",541029,541713,"chrX"
"chrX","YJR057W (CDC8)","+",544781,544867,544758,109,"F-overlap-W",544758,544867,"chrX"
"chrX","YJR058C (APS2 YAP17)","-",544686,544687,544758,71,"F-overlap-F",544687,544758,"chrX"
"chrX","YJR059W (PTK2 STK2)","+",548441,548710,548386,324,"W-open-F",548386,548710,"chrX"
"chrX","YJR060W (CBF1 CEP1 CPF1)","+",550400,550458,550274,184,"W-close-W",550274,550458,"chrX"
"chrX","YJR061W","+",553481,553536,553444,92,"F-overlap-F",553444,553536,"chrX"
"chrX","YJR062C (NTA1 DEA1)","-",552926,552922,553083,161,"F-close-F",552922,553083,"chrX"
"chrX","YJR063W (RPA12 RRN4)","+",555724,555922,555616,306,"F-open-W",555616,555922,"chrX"
"chrX","YJR064W (CCT5 TCP5)","+",557648,557707,557505,202,"W-close-W",557505,557707,"chrX"
"chrX","YJR065C (ARP3 ACT4)","-",557661,557505,557707,202,"W-close-W",557505,557707,"chrX"
"chrX","YJR066W (TOR1 DRR1)","+",566932,567060,566849,211,"F-close-W",566849,567060,"chrX"
"chrX","YJR067C (YAE1)","-",566858,566849,567060,211,"W-close-F",566849,567060,"chrX"
"chrX","YJR068W (RFC2)","+",568775,568856,568583,273,"F-open-W",568583,568856,"chrX"
"chrX","YJR069C (HAM1)","-",568659,568583,568856,273,"W-open-F",568583,568856,"chrX"
"chrX","YJR070C (LIA1 MMD1)","-",569491,569412,569605,193,"F-close-F",569412,569605,"chrX"
"chrX","YJR071W","+",570903,570924,570692,232,"F-open-F",570692,570924,"chrX"
"chrX","YJR072C (NPA3 EPA1)","-",570897,570692,570924,232,"F-open-F",570692,570924,"chrX"
"chrX","YJR073C (OPI3 PEM2)","-",572226,572105,572376,271,"W-open-W",572105,572376,"chrX"
"chrX","YJR074W (MOG1)","+",573852,573961,573700,261,"W-open-W",573700,573961,"chrX"
"chrX","YJR075W (HOC1)","+",575343,575328,575111,217,"W-open-F",575111,575328,"chrX"
"chrX","YJR076C (CDC11 PSL9)","-",575220,575111,575328,217,"F-open-W",575111,575328,"chrX"
"chrX","YJR077C (MIR1)","-",577104,577053,577247,194,"F-close-F",577053,577247,"chrX"
"chrX","YJR080C (AIM24 FMP26)","-",580307,580223,580332,109,"W-overlap-F",580223,580332,"chrX"
"chrX","YJR082C (EAF6)","-",581717,581594,581846,252,"W-open-W",581594,581846,"chrX"
"chrX","YJR083C (ACF4)","-",582522,582350,582612,262,"F-open-W",582350,582612,"chrX"
"chrX","YJR084W (CSN12)","+",585072,585077,584902,175,"W-close-F",584902,585077,"chrX"
"chrX","YJR085C","-",585032,584902,585077,175,"F-close-W",584902,585077,"chrX"
"chrX","YJR086W (STE18)","+",586430,586587,586408,179,"F-close-F",586408,586587,"chrX"
"chrX","YJR087W","+",587324,587371,587207,164,"W-close-W",587207,587371,"chrX"
"chrX","YJR088C (EMC2)","-",586228,586078,586256,178,"W-close-W",586078,586256,"chrX"
"chrX","YJR089W (BIR1)","+",590662,590653,590559,94,"W-overlap-F",590559,590653,"chrX"
"chrX","YJR090C (GRR1 CAT80 COT2 SDC1 SSU2)","-",590756,590741,590949,208,"F-close-F",590741,590949,"chrX"
"chrX","YJR091C (JSN1 PUF1)","-",594778,594567,594841,274,"W-open-W",594567,594841,"chrX"
"chrX","YJR092W (BUD4)","+",603201,603266,603057,209,"F-close-F",603057,603266,"chrX"
"chrX","YJR093C (FIP1)","-",603114,603057,603266,209,"F-close-F",603057,603266,"chrX"
"chrX","YJR094C (IME1)","-",604406,604222,604504,282,"F-open-W",604222,604504,"chrX"
"chrX","YJR094W-A (RPL43B)","+",608988,NA,NA,NA,"+1_missing",608923,609382,"chrX"
"chrX","YJR095W (SFC1 ACR1)","+",610948,611047,610847,200,"F-close-F",610847,611047,"chrX"
"chrX","YJR096W","+",612124,612358,612075,283,"W-open-W",612075,612358,"chrX"
"chrX","YJR097W (JJJ3 DPH4)","+",613059,613256,612919,337,"F-open-W",612919,613256,"chrX"
"chrX","YJR098C","-",612994,612919,613256,337,"W-open-F",612919,613256,"chrX"
"chrX","YJR099W (YUH1)","+",616371,616440,616224,216,"F-open-F",616224,616440,"chrX"
"chrX","YJR100C (AIM25)","-",616279,616224,616440,216,"F-open-F",616224,616440,"chrX"
"chrX","YJR101W (RSM26)","+",619180,619177,619105,72,"F-overlap-F",619105,619177,"chrX"
"chrX","YJR102C (VPS25 VPL12 VPT25)","-",619027,618996,619105,109,"F-overlap-F",618996,619105,"chrX"
"chrX","YJR103W (URA8)","+",622564,622709,622534,175,"W-close-F",622534,622709,"chrX"
"chrX","YJR104C (SOD1 CRS4)","-",622479,622375,622534,159,"W-close-F",622375,622534,"chrX"
"chrX","YJR105W (ADO1)","+",624648,624716,624599,117,"F-overlap-F",624599,624716,"chrX"
"chrX","YJR106W (ECM27)","+",627148,627200,626951,249,"F-open-W",626951,627200,"chrX"
"chrX","YJR107W","+",628458,628506,628307,199,"W-close-W",628307,628506,"chrX"
"chrX","YJR109C (CPA2)","-",629488,629452,629640,188,"F-close-W",629452,629640,"chrX"
"chrX","YJR110W (YMR1)","+",635826,635930,635796,134,"F-close-W",635796,635930,"chrX"
"chrX","YJR111C","-",635746,635695,635796,101,"F-overlap-F",635695,635796,"chrX"
"chrX","YJR112W (NNF1)","+",637712,637831,637572,259,"W-open-W",637572,637831,"chrX"
"chrX","YJR112W-A","+",638276,638319,638146,173,"F-close-W",638146,638319,"chrX"
"chrX","YJR113C (RSM7)","-",638159,638146,638319,173,"W-close-F",638146,638319,"chrX"
"chrX","YJR114W (SRF2)","+",639613,639903,639541,362,"F-open-F",639541,639903,"chrX"
"chrX","YJR115W","+",640744,640868,640660,208,"W-close-W",640660,640868,"chrX"
"chrX","YJR116W","+",641818,642027,641732,295,"W-open-W",641732,642027,"chrX"
"chrX","YJR117W (STE24 AFC1 PIO2)","+",643482,643598,643451,147,"F-close-W",643451,643598,"chrX"
"chrX","YJR118C (ILM1)","-",643388,643361,643451,90,"F-overlap-F",643361,643451,"chrX"
"chrX","YJR119C (JHD2 KDM5)","-",644246,644101,644377,276,"F-open-W",644101,644377,"chrX"
"chrX","YJR121W (ATP2)","+",649392,649486,NA,NA,"-1_missing",649090,649486,"chrX"
"chrX","YJR122W (IBA57 CAF17)","+",651335,NA,NA,NA,"+1_missing",651252,651901,"chrX"
"chrX","YJR123W (RPS5)","+",652698,652866,652528,338,"W-open-W",652528,652866,"chrX"
"chrX","YJR124C","-",652738,652528,652866,338,"W-open-W",652528,652866,"chrX"
"chrX","YJR125C (ENT3)","-",654653,654633,654819,186,"W-close-W",654633,654819,"chrX"
"chrX","YJR126C (VPS70)","-",656177,655974,656238,264,"W-open-W",655974,656238,"chrX"
"chrX","YJR129C","-",663827,663824,664079,255,"F-open-F",663824,664079,"chrX"
"chrX","YJR130C (STR2)","-",665083,664976,665106,130,"F-close-F",664976,665106,"chrX"
"chrX","YJR131W (MNS1)","+",669361,669513,669244,269,"W-open-W",669244,669513,"chrX"
"chrX","YJR132W (NMD5 KAP119)","+",672832,672946,672705,241,"W-open-W",672705,672946,"chrX"
"chrX","YJR133W (XPT1)","+",673726,673803,673617,186,"F-close-W",673617,673803,"chrX"
"chrX","YJR134C (SGM1)","-",673632,673617,673803,186,"W-close-F",673617,673803,"chrX"
"chrX","YJR135C (MCM22)","-",676017,675892,676129,237,"W-open-W",675892,676129,"chrX"
"chrX","YJR135W-A (TIM8)","+",677351,677501,677315,186,"F-close-W",677315,677501,"chrX"
"chrX","YJR136C (TTI2)","-",677355,677315,677501,186,"W-close-F",677315,677501,"chrX"
"chrX","YJR137C (MET5 ECM17)","-",678806,678664,678871,207,"F-close-W",678664,678871,"chrX"
"chrX","YJR138W (IML1)","+",689466,689539,689351,188,"F-close-W",689351,689539,"chrX"
"chrX","YJR139C (HOM6)","-",689368,689351,689539,188,"W-close-F",689351,689539,"chrX"
"chrX","YJR140C (HIR3 HPC1)","-",690545,690418,690573,155,"W-close-W",690418,690573,"chrX"
"chrX","YJR141W","+",697054,697171,696942,229,"W-open-W",696942,697171,"chrX"
"chrX","YJR142W","+",698274,698338,698135,203,"W-close-W",698135,698338,"chrX"
"chrX","YJR143C (PMT4)","-",698197,698135,698338,203,"W-close-W",698135,698338,"chrX"
"chrX","YJR144W (MGM101 MGM9)","+",701757,701767,701583,184,"W-close-F",701583,701767,"chrX"
"chrX","YJR145C (RPS4A)","-",701943,701894,702062,168,"F-close-F",701894,702062,"chrX"
"chrX","YJR148W (BAT2 ECA40 TWT2)","+",706937,706989,706885,104,"F-overlap-W",706885,706989,"chrX"
"chrX","YJR150C (DAN1 CCW13)","-",708704,708653,708816,163,"W-close-F",708653,708816,"chrX"
"chrX","YJR152W (DAL5 UREP1)","+",721386,721457,721250,207,"W-close-F",721250,721457,"chrX"
"chrX","YJR153W (PGU1 PGL1 PSM1)","+",723995,724023,723838,185,"W-close-W",723838,724023,"chrX"
"chrX","YJR155W (AAD10)","+",728347,728499,728324,175,"F-close-F",728324,728499,"chrX"
"chrXI","YKL001C (MET14)","-",438695,438579,438819,240,"W-open-W",438579,438819,"chrXI"
"chrXI","YKL002W (DID4 CHM2 GRD7 REN1 VPL2 VPS14 VPS2 VPT14)","+",438647,438819,438579,240,"W-open-W",438579,438819,"chrXI"
"chrXI","YKL003C (MRP17)","-",436990,436955,437127,172,"W-close-W",436955,437127,"chrXI"
"chrXI","YKL004W (AUR1)","+",436912,436955,436764,191,"W-close-W",436764,436955,"chrXI"
"chrXI","YKL005C (BYE1)","-",432920,432878,432965,87,"F-overlap-W",432878,432965,"chrXI"
"chrXI","YKL006C-A (SFT1)","-",430111,430110,430294,184,"W-close-F",430110,430294,"chrXI"
"chrXI","YKL006W (RPL14A)","+",432810,432878,432712,166,"F-close-W",432712,432878,"chrXI"
"chrXI","YKL007W (CAP1)","+",430246,430294,430110,184,"F-close-W",430110,430294,"chrXI"
"chrXI","YKL008C (LAC1 DGT1)","-",427156,427174,427258,84,"F-overlap-F",427174,427258,"chrXI"
"chrXI","YKL009W (MRT4)","+",427061,427174,427021,153,"F-close-F",427021,427174,"chrXI"
"chrXI","YKL010C (UFD4)","-",421365,421347,421554,207,"F-close-F",421347,421554,"chrXI"
"chrXI","YKL011C (CCE1 MGT1)","-",420064,420003,420125,122,"F-close-F",420003,420125,"chrXI"
"chrXI","YKL012W (PRP40)","+",420199,420327,420125,202,"F-close-F",420125,420327,"chrXI"
"chrXI","YKL013C (ARC19)","-",417333,417167,417394,227,"W-open-W",417167,417394,"chrXI"
"chrXI","YKL014C (URB1 NPA1)","-",411502,411502,411646,144,"F-close-F",411502,411646,"chrXI"
"chrXI","YKL015W (PUT3)","+",411596,411646,411502,144,"F-close-F",411502,411646,"chrXI"
"chrXI","YKL016C (ATP7)","-",407360,407314,407391,77,"F-overlap-F",407314,407391,"chrXI"
"chrXI","YKL017C (HCS1 DIP1)","-",405091,405046,405223,177,"F-close-F",405046,405223,"chrXI"
"chrXI","YKL018C-A","-",403491,403380,403553,173,"W-close-W",403380,403553,"chrXI"
"chrXI","YKL018W (SWD2 CPS35 SAF37)","+",405217,405223,405046,177,"F-close-F",405046,405223,"chrXI"
"chrXI","YKL019W (RAM2)","+",403594,403706,403553,153,"W-close-W",403553,403706,"chrXI"
"chrXI","YKL020C (SPT23)","-",398766,398552,398829,277,"F-open-W",398552,398829,"chrXI"
"chrXI","YKL023W","+",394707,394749,394572,177,"F-close-W",394572,394749,"chrXI"
"chrXI","YKL024C (URA6 SOC8)","-",392421,392267,392555,288,"W-open-W",392267,392555,"chrXI"
"chrXI","YKL025C (PAN3 ECM35)","-",390171,389996,390204,208,"W-close-W",389996,390204,"chrXI"
"chrXI","YKL026C (GPX1)","-",389199,389170,389243,73,"F-overlap-F",389170,389243,"chrXI"
"chrXI","YKL027W","+",389012,389170,388941,229,"W-open-F",388941,389170,"chrXI"
"chrXI","YKL028W (TFA1)","+",387520,387501,NA,NA,"-1_missing",387191,387501,"chrXI"
"chrXI","YKL029C (MAE1)","-",382596,382579,382779,200,"F-close-F",382579,382779,"chrXI"
"chrXI","YKL030W","+",383125,383114,382942,172,"F-close-F",382942,383114,"chrXI"
"chrXI","YKL031W","+",382570,382579,NA,NA,"-1_missing",381988,382579,"chrXI"
"chrXI","YKL032C (IXR1 ORD1)","-",379908,379857,380103,246,"F-open-W",379857,380103,"chrXI"
"chrXI","YKL033W (TTI1 FMP47)","+",378969,379013,378941,72,"F-overlap-F",378941,379013,"chrXI"
"chrXI","YKL033W-A","+",375285,375479,375245,234,"W-open-W",375245,375479,"chrXI"
"chrXI","YKL034W (TUL1)","+",374192,374209,374019,190,"W-close-F",374019,374209,"chrXI"
"chrXI","YKL035W (UGP1)","+",371543,371775,371510,265,"F-open-W",371510,371775,"chrXI"
"chrXI","YKL036C","-",369197,369212,369337,125,"W-close-F",369212,369337,"chrXI"
"chrXI","YKL038W (RGT1)","+",369283,369337,369212,125,"F-close-W",369212,369337,"chrXI"
"chrXI","YKL039W (PTM1)","+",364428,364649,364357,292,"F-open-W",364357,364649,"chrXI"
"chrXI","YKL040C (NFU1 NUB1)","-",360808,360738,360866,128,"F-close-W",360738,360866,"chrXI"
"chrXI","YKL041W (VPS24 DID3 VPL26)","+",360894,360994,360866,128,"F-close-W",360866,360994,"chrXI"
"chrXI","YKL042W (SPC42)","+",359780,359827,359652,175,"W-close-W",359652,359827,"chrXI"
"chrXI","YKL043W (PHD1)","+",358038,358121,357927,194,"W-close-W",357927,358121,"chrXI"
"chrXI","YKL044W","+",356658,356781,356628,153,"F-close-W",356628,356781,"chrXI"
"chrXI","YKL045W (PRI2)","+",355182,355291,355088,203,"F-close-F",355088,355291,"chrXI"
"chrXI","YKL046C (DCW1)","-",351055,350984,351162,178,"W-close-W",350984,351162,"chrXI"
"chrXI","YKL047W","+",351122,351162,350984,178,"W-close-W",350984,351162,"chrXI"
"chrXI","YKL048C (ELM1 LDB9)","-",347037,347039,347222,183,"W-close-W",347039,347222,"chrXI"
"chrXI","YKL049C (CSE4 CSL2)","-",345963,345921,346100,179,"W-close-W",345921,346100,"chrXI"
"chrXI","YKL050C","-",342668,342642,342879,237,"W-open-F",342642,342879,"chrXI"
"chrXI","YKL051W (SFK1)","+",342705,342879,342642,237,"F-open-W",342642,342879,"chrXI"
"chrXI","YKL052C (ASK1)","-",339628,339459,339747,288,"W-open-W",339459,339747,"chrXI"
"chrXI","YKL053C-A (MDM35)","-",339070,338865,339181,316,"W-open-W",338865,339181,"chrXI"
"chrXI","YKL053W","+",341226,341358,341157,201,"W-close-W",341157,341358,"chrXI"
"chrXI","YKL054C (DEF1 VID31)","-",336322,336135,336574,439,"F-open-W",336135,336574,"chrXI"
"chrXI","YKL055C (OAR1)","-",335130,334995,335365,370,"W-open-F",334995,335365,"chrXI"
"chrXI","YKL056C (TMA19 MMI1 RBF18)","-",334244,333973,334295,322,"W-open-W",333973,334295,"chrXI"
"chrXI","YKL057C (NUP120 RAT2)","-",330806,330661,330846,185,"F-close-F",330661,330846,"chrXI"
"chrXI","YKL058W (TOA2)","+",330766,330846,330661,185,"F-close-F",330661,330846,"chrXI"
"chrXI","YKL059C (MPE1)","-",328020,327742,328145,403,"W-open-W",327742,328145,"chrXI"
"chrXI","YKL060C (FBA1 LOT1)","-",326356,326165,326518,353,"F-open-F",326165,326518,"chrXI"
"chrXI","YKL061W (BLI1)","+",326362,326518,326165,353,"F-open-F",326165,326518,"chrXI"
"chrXI","YKL062W (MSN4)","+",325329,325370,325212,158,"F-close-W",325212,325370,"chrXI"
"chrXI","YKL063C","-",320844,320733,321017,284,"F-open-F",320733,321017,"chrXI"
"chrXI","YKL064W (MNR2)","+",320709,320733,320559,174,"W-close-F",320559,320733,"chrXI"
"chrXI","YKL065C (YET1)","-",316324,316220,316411,191,"W-close-F",316220,316411,"chrXI"
"chrXI","YKL065W-A","+",316283,316411,316220,191,"F-close-W",316220,316411,"chrXI"
"chrXI","YKL066W","+",315808,315999,315788,211,"W-close-F",315788,315999,"chrXI"
"chrXI","YKL067W (YNK1 NDK1)","+",315405,315461,315268,193,"W-close-F",315268,315461,"chrXI"
"chrXI","YKL068W (NUP100 NSP100)","+",313180,313278,313081,197,"W-close-W",313081,313278,"chrXI"
"chrXI","YKL068W-A","+",309697,309692,309495,197,"W-close-F",309495,309692,"chrXI"
"chrXI","YKL069W (YKG9 fRMsr)","+",307879,307993,307813,180,"W-close-W",307813,307993,"chrXI"
"chrXI","YKL070W","+",307057,307044,306863,181,"W-close-W",306863,307044,"chrXI"
"chrXI","YKL071W","+",305980,306046,305863,183,"F-close-W",305863,306046,"chrXI"
"chrXI","YKL072W (STB6)","+",302022,302085,301928,157,"F-close-W",301928,302085,"chrXI"
"chrXI","YKL073W (LHS1 CER1 SSI1)","+",299168,299412,299117,295,"W-open-F",299117,299412,"chrXI"
"chrXI","YKL074C (MUD2)","-",294536,294366,294584,218,"F-open-W",294366,294584,"chrXI"
"chrXI","YKL075C","-",292761,292729,292893,164,"W-close-W",292729,292893,"chrXI"
"chrXI","YKL077W","+",292862,292893,292729,164,"W-close-W",292729,292893,"chrXI"
"chrXI","YKL078W (DHR2)","+",291136,291130,290975,155,"W-close-F",290975,291130,"chrXI"
"chrXI","YKL079W (SMY1)","+",288646,288872,288598,274,"W-open-W",288598,288872,"chrXI"
"chrXI","YKL080W (VMA5 CSL5 VAT3)","+",286279,286328,286128,200,"W-close-W",286128,286328,"chrXI"
"chrXI","YKL081W (TEF4 EFC1)","+",284660,NA,NA,NA,"+1_missing",284628,284963,"chrXI"
"chrXI","YKL082C (RRP14)","-",280911,280835,281095,260,"F-open-W",280835,281095,"chrXI"
"chrXI","YKL084W (HOT13)","+",280872,281095,280835,260,"W-open-F",280835,281095,"chrXI"
"chrXI","YKL085W (MDH1)","+",280280,280489,280212,277,"F-open-F",280212,280489,"chrXI"
"chrXI","YKL086W (SRX1)","+",278734,278765,278690,75,"F-overlap-F",278690,278765,"chrXI"
"chrXI","YKL087C (CYT2)","-",277062,276925,277243,318,"W-open-W",276925,277243,"chrXI"
"chrXI","YKL088W (CAB3)","+",277208,277243,276925,318,"W-open-W",276925,277243,"chrXI"
"chrXI","YKL089W (MIF2)","+",275140,275308,275023,285,"W-open-W",275023,275308,"chrXI"
"chrXI","YKL090W (CUE2)","+",273374,273423,273151,272,"W-open-W",273151,273423,"chrXI"
"chrXI","YKL091C (SFH1)","-",269616,269492,269733,241,"W-open-W",269492,269733,"chrXI"
"chrXI","YKL092C (BUD2 CLA2 ERC25)","-",266015,265982,266179,197,"F-close-F",265982,266179,"chrXI"
"chrXI","YKL093W (MBR1)","+",265975,265982,265897,85,"F-overlap-F",265897,265982,"chrXI"
"chrXI","YKL094W (YJU3)","+",264379,264394,264201,193,"W-close-W",264201,264394,"chrXI"
"chrXI","YKL095W (YJU2 CWC16)","+",263326,263391,263179,212,"F-close-W",263179,263391,"chrXI"
"chrXI","YKL096C-B","-",259023,NA,NA,NA,"+1_missing",258559,259116,"chrXI"
"chrXI","YKL096W (CWP1 YJU1)","+",261947,262165,261873,292,"W-open-W",261873,262165,"chrXI"
"chrXI","YKL096W-A (CWP2 LPR1 YKL097W-A)","+",259705,259741,259492,249,"F-open-W",259492,259741,"chrXI"
"chrXI","YKL098W (MTC2)","+",257950,258092,257841,251,"W-open-W",257841,258092,"chrXI"
"chrXI","YKL099C (UTP11)","-",255616,255444,255727,283,"W-open-W",255444,255727,"chrXI"
"chrXI","YKL100C","-",253456,253395,253669,274,"F-open-F",253395,253669,"chrXI"
"chrXI","YKL100W-A","+",254369,254470,254317,153,"F-close-W",254317,254470,"chrXI"
"chrXI","YKL101W (HSL1 ELM2 NIK1)","+",253532,253669,253395,274,"F-open-F",253395,253669,"chrXI"
"chrXI","YKL102C","-",247701,247647,247723,76,"F-overlap-F",247647,247723,"chrXI"
"chrXI","YKL103C (LAP4 APE1 API YSC1)","-",245961,245919,246197,278,"W-open-W",245919,246197,"chrXI"
"chrXI","YKL104C (GFA1)","-",242979,242955,243160,205,"W-close-F",242955,243160,"chrXI"
"chrXI","YKL105C","-",238988,238919,239108,189,"F-close-F",238919,239108,"chrXI"
"chrXI","YKL106C-A","-",236573,236534,236665,131,"F-close-F",236534,236665,"chrXI"
"chrXI","YKL106W (AAT1)","+",239020,239108,238919,189,"F-close-F",238919,239108,"chrXI"
"chrXI","YKL107W","+",237131,237256,237025,231,"W-open-F",237025,237256,"chrXI"
"chrXI","YKL108W (SLD2 DRC1)","+",235867,235905,235795,110,"F-overlap-F",235795,235905,"chrXI"
"chrXI","YKL109W (HAP4)","+",234243,234454,234202,252,"F-open-W",234202,234454,"chrXI"
"chrXI","YKL110C (KTI12 TOT4)","-",228809,228726,228843,117,"F-overlap-W",228726,228843,"chrXI"
"chrXI","YKL112W (ABF1 BAF1 OBF1 REB2 SBF1)","+",228906,229055,228843,212,"F-close-F",228843,229055,"chrXI"
"chrXI","YKL113C (RAD27 ERC11 FEN1 RTH1)","-",224619,224448,224667,219,"W-open-W",224448,224667,"chrXI"
"chrXI","YKL114C (APN1)","-",223319,223291,223458,167,"W-close-W",223291,223458,"chrXI"
"chrXI","YKL116C (PRR1)","-",221202,221165,221382,217,"F-open-F",221165,221382,"chrXI"
"chrXI","YKL117W (SBA1)","+",221177,221165,220991,174,"W-close-F",220991,221165,"chrXI"
"chrXI","YKL118W","+",219829,220057,219765,292,"W-open-F",219765,220057,"chrXI"
"chrXI","YKL119C (VPH2 CLS10 VMA12)","-",218429,218359,218537,178,"W-close-W",218359,218537,"chrXI"
"chrXI","YKL120W (OAC1)","+",218502,218537,218359,178,"W-close-W",218359,218537,"chrXI"
"chrXI","YKL121W (DGR2)","+",216824,216986,216707,279,"W-open-W",216707,216986,"chrXI"
"chrXI","YKL122C (SRP21)","-",212413,212309,212469,160,"F-close-W",212309,212469,"chrXI"
"chrXI","YKL124W (SSH4 MLF4)","+",212466,212469,212309,160,"W-close-F",212309,212469,"chrXI"
"chrXI","YKL125W (RRN3)","+",210289,210514,210195,319,"F-open-W",210195,210514,"chrXI"
"chrXI","YKL126W (YPK1 SLI2)","+",207822,207875,207690,185,"W-close-W",207690,207875,"chrXI"
"chrXI","YKL127W (PGM1)","+",205397,205541,205284,257,"W-open-W",205284,205541,"chrXI"
"chrXI","YKL128C (PMU1)","-",200694,200606,200760,154,"F-close-F",200606,200760,"chrXI"
"chrXI","YKL129C (MYO3)","-",196243,196068,196342,274,"W-open-W",196068,196342,"chrXI"
"chrXI","YKL130C (SHE2)","-",195154,194985,195247,262,"W-open-W",194985,195247,"chrXI"
"chrXI","YKL132C (RMA1)","-",193417,193324,193482,158,"W-close-W",193324,193482,"chrXI"
"chrXI","YKL133C","-",191624,191440,191719,279,"W-open-W",191440,191719,"chrXI"
"chrXI","YKL134C (OCT1)","-",188866,188724,188993,269,"W-open-W",188724,188993,"chrXI"
"chrXI","YKL135C (APL2)","-",186339,186279,186499,220,"W-open-F",186279,186499,"chrXI"
"chrXI","YKL137W (CMC1)","+",186405,186499,186279,220,"F-open-W",186279,186499,"chrXI"
"chrXI","YKL138C (MRPL31)","-",185171,185001,185206,205,"F-close-W",185001,185206,"chrXI"
"chrXI","YKL138C-A (HSK3)","-",184521,184481,184661,180,"W-close-F",184481,184661,"chrXI"
"chrXI","YKL139W (CTK1)","+",184607,184661,184481,180,"F-close-W",184481,184661,"chrXI"
"chrXI","YKL140W (TGL1 YKL5)","+",182588,182821,182541,280,"W-open-W",182541,182821,"chrXI"
"chrXI","YKL141W (SDH3 CYB3 YKL4)","+",180381,180380,180169,211,"W-close-F",180169,180380,"chrXI"
"chrXI","YKL142W (MRP8 YKL3)","+",179314,179397,179183,214,"F-close-W",179183,179397,"chrXI"
"chrXI","YKL143W (LTV1 YKL2)","+",178260,178461,178139,322,"W-open-W",178139,178461,"chrXI"
"chrXI","YKL144C (RPC25 YKL1)","-",175716,175642,175823,181,"W-close-W",175642,175823,"chrXI"
"chrXI","YKL145W (RPT1 CIM5 YTA3)","+",175679,175823,175642,181,"W-close-W",175642,175823,"chrXI"
"chrXI","YKL145W-A","+",175715,175823,175642,181,"W-close-W",175642,175823,"chrXI"
"chrXI","YKL146W (AVT3)","+",173947,174174,173906,268,"W-open-F",173906,174174,"chrXI"
"chrXI","YKL148C (SDH1 SDHA)","-",169034,168787,169251,464,"W-open-W",168787,169251,"chrXI"
"chrXI","YKL149C (DBR1 PRP26)","-",167483,167328,167522,194,"F-close-F",167328,167522,"chrXI"
"chrXI","YKL150W (MCR1)","+",167572,167607,167522,85,"F-overlap-F",167522,167607,"chrXI"
"chrXI","YKL151C","-",164817,164585,164946,361,"W-open-W",164585,164946,"chrXI"
"chrXI","YKL152C (GPM1)","-",163500,163433,163524,91,"F-overlap-F",163433,163524,"chrXI"
"chrXI","YKL153W","+",164438,164585,164400,185,"F-close-W",164400,164585,"chrXI"
"chrXI","YKL154W (SRP102)","+",162400,162446,162369,77,"W-overlap-F",162369,162446,"chrXI"
"chrXI","YKL155C (RSM22)","-",159411,159386,159570,184,"F-close-F",159386,159570,"chrXI"
"chrXI","YKL156C-A","-",158566,158301,158626,325,"W-open-F",158301,158626,"chrXI"
"chrXI","YKL156W (RPS27A)","+",159439,159570,159386,184,"F-close-F",159386,159570,"chrXI"
"chrXI","YKL157W (APE2 LAP1 YKL158W)","+",158376,158626,158301,325,"F-open-W",158301,158626,"chrXI"
"chrXI","YKL159C (RCN1)","-",153701,153638,153798,160,"F-close-W",153638,153798,"chrXI"
"chrXI","YKL160W (ELF1)","+",153796,153798,153638,160,"W-close-F",153638,153798,"chrXI"
"chrXI","YKL161C (KDX1 MLP1)","-",149062,148894,149158,264,"W-open-W",148894,149158,"chrXI"
"chrXI","YKL162C","-",147481,147432,147628,196,"W-close-W",147432,147628,"chrXI"
"chrXI","YKL162C-A","-",145604,145497,145708,211,"F-close-F",145497,145708,"chrXI"
"chrXI","YKL163W (PIR3 CCW8)","+",145727,145708,145497,211,"F-close-F",145497,145708,"chrXI"
"chrXI","YKL164C (PIR1 CCW6)","-",141551,141431,141646,215,"F-close-W",141431,141646,"chrXI"
"chrXI","YKL165C (MCD4 FSR2 SSU21 ZRG16)","-",137815,137802,137965,163,"W-close-W",137802,137965,"chrXI"
"chrXI","YKL166C (TPK3)","-",134289,134097,134378,281,"W-open-W",134097,134378,"chrXI"
"chrXI","YKL167C (MRP49)","-",133569,133419,133596,177,"F-close-W",133419,133596,"chrXI"
"chrXI","YKL168C (KKQ8)","-",131186,131079,131254,175,"W-close-F",131079,131254,"chrXI"
"chrXI","YKL169C","-",130289,130140,130350,210,"W-close-W",130140,130350,"chrXI"
"chrXI","YKL170W (MRPL38 MRPL34)","+",131196,131254,131079,175,"F-close-W",131079,131254,"chrXI"
"chrXI","YKL171W (NNK1)","+",130410,130610,130350,260,"W-open-W",130350,130610,"chrXI"
"chrXI","YKL172W (EBP2)","+",127141,127410,127015,395,"W-open-W",127015,127410,"chrXI"
"chrXI","YKL173W (SNU114 GIN10)","+",125646,125775,125487,288,"W-open-W",125487,125775,"chrXI"
"chrXI","YKL174C (TPO5)","-",120290,120252,120431,179,"F-close-F",120252,120431,"chrXI"
"chrXI","YKL175W (ZRT3)","+",120397,120431,120252,179,"F-close-F",120252,120431,"chrXI"
"chrXI","YKL176C (LST4)","-",115326,115290,115505,215,"W-close-W",115290,115505,"chrXI"
"chrXI","YKL178C (STE3 DAF2)","-",112938,112954,113121,167,"W-close-W",112954,113121,"chrXI"
"chrXI","YKL179C (COY1)","-",110333,110265,110424,159,"F-close-F",110265,110424,"chrXI"
"chrXI","YKL180W (RPL17A RPL17)","+",110221,110265,110058,207,"W-close-F",110058,110265,"chrXI"
"chrXI","YKL181W (PRS1 PRP1)","+",108708,108773,108599,174,"W-close-W",108599,108773,"chrXI"
"chrXI","YKL182W (FAS1)","+",106907,107159,106865,294,"F-open-W",106865,107159,"chrXI"
"chrXI","YKL183C-A","-",98350,98283,98615,332,"W-open-W",98283,98615,"chrXI"
"chrXI","YKL183W (LOT5)","+",99783,NA,NA,NA,"+1_missing",99628,100142,"chrXI"
"chrXI","YKL184W (SPE1 ORD1 SPE10)","+",98440,98615,98283,332,"W-open-W",98283,98615,"chrXI"
"chrXI","YKL185W (ASH1)","+",96378,96593,96253,340,"W-open-W",96253,96593,"chrXI"
"chrXI","YKL186C (MTR2)","-",92649,92612,92843,231,"F-open-W",92612,92843,"chrXI"
"chrXI","YKL187C","-",89113,88902,89156,254,"F-open-W",88902,89156,"chrXI"
"chrXI","YKL189W (HYM1)","+",86075,86072,85989,83,"F-overlap-W",85989,86072,"chrXI"
"chrXI","YKL190W (CNB1 CRV1 YCN2)","+",83718,83765,83587,178,"F-close-W",83587,83765,"chrXI"
"chrXI","YKL191W (DPH2)","+",82732,82956,82629,327,"W-open-W",82629,82956,"chrXI"
"chrXI","YKL192C (ACP1)","-",80017,79857,80072,215,"F-close-W",79857,80072,"chrXI"
"chrXI","YKL193C (SDS22 EGP1)","-",78760,78622,78873,251,"F-open-W",78622,78873,"chrXI"
"chrXI","YKL194C (MST1)","-",77049,76983,77151,168,"W-close-W",76983,77151,"chrXI"
"chrXI","YKL195W (MIA40 FMP15 TIM40)","+",77161,77151,76983,168,"W-close-W",76983,77151,"chrXI"
"chrXI","YKL196C (YKT6)","-",74772,74484,74818,334,"W-open-W",74484,74818,"chrXI"
"chrXI","YKL197C (PEX1 PAS1)","-",70363,70285,70473,188,"W-close-W",70285,70473,"chrXI"
"chrXI","YKL198C (PTK1 KKT8 POT1 STK1 YKL199C YKT9)","-",68107,NA,NA,NA,"+1_missing",67640,68216,"chrXI"
"chrXI","YKL201C (MNN4 YKL200C)","-",63739,63505,63772,267,"W-open-W",63505,63772,"chrXI"
"chrXI","YKL203C (TOR2 DRR2)","-",55855,55808,55976,168,"W-close-F",55808,55976,"chrXI"
"chrXI","YKL204W (EAP1)","+",55776,55808,55726,82,"F-overlap-F",55726,55808,"chrXI"
"chrXI","YKL205W (LOS1)","+",53479,53726,53440,286,"W-open-W",53440,53726,"chrXI"
"chrXI","YKL206C (ADD66 PBA2 POC2)","-",48940,48843,49003,160,"F-close-W",48843,49003,"chrXI"
"chrXI","YKL207W (AIM27 EMC3 LRC3)","+",49023,49079,49003,76,"F-overlap-F",49003,49079,"chrXI"
"chrXI","YKL208W (CBT1 SOC1)","+",48085,48202,47956,246,"W-open-W",47956,48202,"chrXI"
"chrXI","YKL209C (STE6)","-",42258,42153,42368,215,"F-close-F",42153,42368,"chrXI"
"chrXI","YKL210W (UBA1)","+",42329,42368,42153,215,"F-close-F",42153,42368,"chrXI"
"chrXI","YKL211C (TRP3)","-",36540,36522,36743,221,"F-open-F",36522,36743,"chrXI"
"chrXI","YKL212W (SAC1 RSD1)","+",36493,36522,36348,174,"W-close-F",36348,36522,"chrXI"
"chrXI","YKL213C (DOA1 UFD3 ZZZ4)","-",31887,31720,31938,218,"W-open-W",31720,31938,"chrXI"
"chrXI","YKL214C (YRA2)","-",31016,30893,31093,200,"W-close-W",30893,31093,"chrXI"
"chrXI","YKL215C (OXP1)","-",26659,26600,26702,102,"F-overlap-F",26600,26702,"chrXI"
"chrXI","YKL216W (URA1)","+",26448,26519,26325,194,"F-close-W",26325,26519,"chrXI"
"chrXI","YKL217W (JEN1)","+",24218,24334,24144,190,"W-close-W",24144,24334,"chrXI"
"chrXI","YKL218C (SRY1)","-",17159,17076,17191,115,"F-overlap-F",17076,17191,"chrXI"
"chrXI","YKL220C (FRE2)","-",8915,8823,9024,201,"F-close-F",8823,9024,"chrXI"
"chrXI","YKL222C","-",3228,3220,3390,170,"W-close-F",3220,3390,"chrXI"
"chrXI","YKR001C (VPS1 GRD1 LAM1 SPO15 VPL1 VPT26)","-",440476,440375,440552,177,"W-close-W",440375,440552,"chrXI"
"chrXI","YKR002W (PAP1)","+",445014,445063,444872,191,"W-close-W",444872,445063,"chrXI"
"chrXI","YKR003W (OSH6)","+",446832,446927,446678,249,"F-open-F",446678,446927,"chrXI"
"chrXI","YKR004C (ECM9 YKR004C-A)","-",446722,446678,446927,249,"F-open-F",446678,446927,"chrXI"
"chrXI","YKR005C","-",448292,448305,448477,172,"W-close-W",448305,448477,"chrXI"
"chrXI","YKR006C (MRPL13 YK105)","-",450332,450221,450395,174,"W-close-F",450221,450395,"chrXI"
"chrXI","YKR007W (MEH1 EGO1 GSE2)","+",452072,452236,451926,310,"W-open-W",451926,452236,"chrXI"
"chrXI","YKR008W (RSC4)","+",454196,454254,454114,140,"F-close-F",454114,454254,"chrXI"
"chrXI","YKR009C (FOX2 POX2)","-",454217,454114,454254,140,"F-close-F",454114,454254,"chrXI"
"chrXI","YKR010C (TOF2)","-",458804,458767,458961,194,"W-close-W",458767,458961,"chrXI"
"chrXI","YKR011C (TOS5)","-",461520,461304,461615,311,"W-open-W",461304,461615,"chrXI"
"chrXI","YKR012C","-",463284,463257,463449,192,"W-close-F",463257,463449,"chrXI"
"chrXI","YKR013W (PRY2 YFW12)","+",465075,465112,464976,136,"F-close-W",464976,465112,"chrXI"
"chrXI","YKR014C (YPT52)","-",465272,465112,465355,243,"F-open-W",465112,465355,"chrXI"
"chrXI","YKR015C","-",466760,466776,466937,161,"W-close-W",466776,466937,"chrXI"
"chrXI","YKR016W (FCJ1 AIM28 FMP13)","+",471562,471656,471504,152,"F-close-F",471504,471656,"chrXI"
"chrXI","YKR017C","-",471525,471504,471656,152,"F-close-F",471504,471656,"chrXI"
"chrXI","YKR018C","-",473564,473428,473671,243,"W-open-W",473428,473671,"chrXI"
"chrXI","YKR019C (IRS4)","-",476123,475893,476151,258,"W-open-W",475893,476151,"chrXI"
"chrXI","YKR020W (VPS51 API3 VPS67 WHI6)","+",479069,479202,478984,218,"F-open-W",478984,479202,"chrXI"
"chrXI","YKR021W (ALY1 ART6)","+",482156,482169,481965,204,"F-close-W",481965,482169,"chrXI"
"chrXI","YKR022C (NTR2)","-",482047,481965,482169,204,"W-close-F",481965,482169,"chrXI"
"chrXI","YKR023W","+",485095,485117,484949,168,"W-close-F",484949,485117,"chrXI"
"chrXI","YKR024C (DBP7)","-",485067,484949,485117,168,"F-close-W",484949,485117,"chrXI"
"chrXI","YKR025W (RPC37)","+",488692,488740,488657,83,"F-overlap-F",488657,488740,"chrXI"
"chrXI","YKR026C (GCN3 AAS2)","-",488559,488476,488657,181,"F-close-W",488476,488657,"chrXI"
"chrXI","YKR027W (BCH2 FMP50)","+",493748,493911,493611,300,"F-open-W",493611,493911,"chrXI"
"chrXI","YKR028W (SAP190)","+",497526,497728,497413,315,"F-open-F",497413,497728,"chrXI"
"chrXI","YKR029C (SET3)","-",497471,497413,497728,315,"F-open-F",497413,497728,"chrXI"
"chrXI","YKR030W (GMH1 MSG1)","+",501219,501284,501162,122,"F-close-W",501162,501284,"chrXI"
"chrXI","YKR031C (SPO14 PLD1)","-",501117,501091,501162,71,"F-overlap-F",501091,501162,"chrXI"
"chrXI","YKR035C (OPI8)","-",507877,507679,507962,283,"W-open-W",507679,507962,"chrXI"
"chrXI","YKR035W-A (DID2 CHM1 FTI1 VPL30 VPS46)","+",508681,508791,508618,173,"F-close-W",508618,508791,"chrXI"
"chrXI","YKR036C (CAF4)","-",508583,508469,508618,149,"F-close-W",508469,508618,"chrXI"
"chrXI","YKR037C (SPC34)","-",510744,510603,510829,226,"W-open-W",510603,510829,"chrXI"
"chrXI","YKR038C (KAE1)","-",511881,511780,512024,244,"W-open-W",511780,512024,"chrXI"
"chrXI","YKR039W (GAP1)","+",516997,517188,516777,411,"W-open-F",516777,517188,"chrXI"
"chrXI","YKR040C","-",518052,517831,518305,474,"F-open-W",517831,518305,"chrXI"
"chrXI","YKR041W","+",519364,519355,NA,NA,"-1_missing",518885,519355,"chrXI"
"chrXI","YKR042W (UTH1)","+",520852,520906,520709,197,"F-close-F",520709,520906,"chrXI"
"chrXI","YKR043C","-",520751,520709,520906,197,"F-close-F",520709,520906,"chrXI"
"chrXI","YKR044W (UIP5)","+",523414,523463,523283,180,"W-close-W",523283,523463,"chrXI"
"chrXI","YKR045C","-",522515,522486,522651,165,"W-close-W",522486,522651,"chrXI"
"chrXI","YKR046C (PET10)","-",524059,523968,524193,225,"W-open-W",523968,524193,"chrXI"
"chrXI","YKR048C (NAP1)","-",525255,525056,525325,269,"W-open-W",525056,525325,"chrXI"
"chrXI","YKR049C (FMP46)","-",526767,526611,526892,281,"W-open-W",526611,526892,"chrXI"
"chrXI","YKR050W (TRK2 RPD2)","+",530577,530647,530455,192,"W-close-W",530455,530647,"chrXI"
"chrXI","YKR051W","+",532278,532455,532235,220,"W-open-F",532235,532455,"chrXI"
"chrXI","YKR052C (MRS4)","-",532193,532151,532235,84,"W-overlap-F",532151,532235,"chrXI"
"chrXI","YKR053C (YSR3 LBP2)","-",533984,533822,534037,215,"W-close-W",533822,534037,"chrXI"
"chrXI","YKR054C (DYN1 DHC1 PAC6)","-",535414,535284,535491,207,"W-close-F",535284,535491,"chrXI"
"chrXI","YKR055W (RHO4)","+",549393,549600,549332,268,"W-open-W",549332,549600,"chrXI"
"chrXI","YKR056W (TRM2 NUC2 NUD1 RNC1)","+",551441,551667,551301,366,"W-open-W",551301,551667,"chrXI"
"chrXI","YKR057W (RPS21A RPS25)","+",552441,552563,552384,179,"W-close-F",552384,552563,"chrXI"
"chrXI","YKR058W (GLG1)","+",554725,554931,554657,274,"F-open-W",554657,554931,"chrXI"
"chrXI","YKR059W (TIF1)","+",556296,556314,556131,183,"W-close-F",556131,556314,"chrXI"
"chrXI","YKR060W (UTP30)","+",557458,557614,557352,262,"W-open-F",557352,557614,"chrXI"
"chrXI","YKR061W (KTR2)","+",559031,559134,558975,159,"F-close-W",558975,559134,"chrXI"
"chrXI","YKR062W (TFA2)","+",560800,560790,560699,91,"F-overlap-W",560699,560790,"chrXI"
"chrXI","YKR063C (LAS1)","-",560660,560622,560699,77,"F-overlap-W",560622,560699,"chrXI"
"chrXI","YKR064W (OAF3)","+",565296,565363,565240,123,"F-close-W",565240,565363,"chrXI"
"chrXI","YKR065C (PAM17 FMP18)","-",565163,565172,565240,68,"F-overlap-W",565172,565240,"chrXI"
"chrXI","YKR066C (CCP1)","-",566015,565864,566157,293,"W-open-W",565864,566157,"chrXI"
"chrXI","YKR067W (GPT2 GAT1)","+",570304,570403,570261,142,"F-close-W",570261,570403,"chrXI"
"chrXI","YKR068C (BET3)","-",570209,570048,570261,213,"F-close-F",570048,570261,"chrXI"
"chrXI","YKR069W (MET1 MET20)","+",573428,573631,573402,229,"W-open-W",573402,573631,"chrXI"
"chrXI","YKR070W","+",574816,574826,574620,206,"W-close-W",574620,574826,"chrXI"
"chrXI","YKR071C (DRE2)","-",574680,574620,574826,206,"W-close-W",574620,574826,"chrXI"
"chrXI","YKR072C (SIS2 HAL3)","-",576335,576286,576469,183,"W-close-W",576286,576469,"chrXI"
"chrXI","YKR074W (AIM29)","+",579800,579856,579726,130,"F-close-F",579726,579856,"chrXI"
"chrXI","YKR075C","-",579683,579650,579726,76,"F-overlap-F",579650,579726,"chrXI"
"chrXI","YKR075W-A","+",580824,580913,580789,124,"F-close-F",580789,580913,"chrXI"
"chrXI","YKR076W (ECM4 GTO2)","+",583450,583609,583332,277,"W-open-W",583332,583609,"chrXI"
"chrXI","YKR077W (MSA2)","+",584828,584981,584768,213,"W-close-W",584768,584981,"chrXI"
"chrXI","YKR078W","+",586759,586885,586622,263,"F-open-F",586622,586885,"chrXI"
"chrXI","YKR079C (TRZ1)","-",586643,586622,586885,263,"F-open-F",586622,586885,"chrXI"
"chrXI","YKR080W (MTD1)","+",591501,591583,591292,291,"F-open-F",591292,591583,"chrXI"
"chrXI","YKR081C (RPF2)","-",591412,591292,591583,291,"F-open-F",591292,591583,"chrXI"
"chrXI","YKR082W (NUP133 RAT3)","+",596378,596481,596177,304,"W-open-W",596177,596481,"chrXI"
"chrXI","YKR083C (DAD2 HSK1)","-",596275,596177,596481,304,"W-open-W",596177,596481,"chrXI"
"chrXI","YKR084C (HBS1)","-",596953,596839,597091,252,"W-open-W",596839,597091,"chrXI"
"chrXI","YKR085C (MRPL20)","-",599006,598899,599130,231,"W-open-W",598899,599130,"chrXI"
"chrXI","YKR086W (PRP16 PRP23 RNA16)","+",603165,603216,603144,72,"F-overlap-F",603144,603216,"chrXI"
"chrXI","YKR087C (OMA1)","-",603095,602999,603144,145,"F-close-W",602999,603144,"chrXI"
"chrXI","YKR088C (TVP38)","-",604332,604205,604449,244,"W-open-F",604205,604449,"chrXI"
"chrXI","YKR089C (TGL4 STC1)","-",605538,605390,605652,262,"W-open-W",605390,605652,"chrXI"
"chrXI","YKR090W (PXL1)","+",611226,611210,611020,190,"W-close-W",611020,611210,"chrXI"
"chrXI","YKR091W (SRL3)","+",612393,612533,612144,389,"F-open-F",612144,612533,"chrXI"
"chrXI","YKR092C (SRP40)","-",612450,NA,NA,NA,"+1_missing",612144,612533,"chrXI"
"chrXI","YKR093W (PTR2)","+",617735,617771,617597,174,"F-close-F",617597,617771,"chrXI"
"chrXI","YKR094C (RPL40B CEP52B UB12 UBI2)","-",617818,617771,617944,173,"F-close-F",617771,617944,"chrXI"
"chrXI","YKR095W (MLP1 MPL1)","+",625619,625878,625592,286,"F-open-W",625592,625878,"chrXI"
"chrXI","YKR095W-A (PCC1)","+",626326,626315,626116,199,"F-close-F",626116,626315,"chrXI"
"chrXI","YKR096W","+",630490,NA,NA,NA,"+1_missing",630376,630847,"chrXI"
"chrXI","YKR097W (PCK1 JPM2 PPC1)","+",632832,632974,632745,229,"F-open-F",632745,632974,"chrXI"
"chrXI","YKR098C (UBP11)","-",632942,632745,632974,229,"F-open-F",632745,632974,"chrXI"
"chrXI","YKR099W (BAS1)","+",638394,638429,638353,76,"W-overlap-F",638353,638429,"chrXI"
"chrXI","YKR100C (SKG1 YKR099C-A)","-",638723,638672,638770,98,"W-overlap-F",638672,638770,"chrXI"
"chrXI","YKR101W (SIR1)","+",642736,643012,642690,322,"W-open-W",642690,643012,"chrXI"
"chrXII","YLL001W (DNM1)","+",150330,150467,150294,173,"W-close-W",150294,150467,"chrXII"
"chrXII","YLL002W (RTT109 KIM2 REM50)","+",147675,147878,147597,281,"W-open-W",147597,147878,"chrXII"
"chrXII","YLL003W (SFI1)","+",146101,146304,146068,236,"W-open-W",146068,146304,"chrXII"
"chrXII","YLL004W (ORC3)","+",142998,143199,142949,250,"W-open-W",142949,143199,"chrXII"
"chrXII","YLL006W (MMM1 YME6)","+",138471,138528,138363,165,"W-close-F",138363,138528,"chrXII"
"chrXII","YLL007C","-",134160,134047,134190,143,"F-close-F",134047,134190,"chrXII"
"chrXII","YLL008W (DRS1)","+",134098,134190,134047,143,"F-close-F",134047,134190,"chrXII"
"chrXII","YLL009C (COX17)","-",131085,130966,131120,154,"W-close-F",130966,131120,"chrXII"
"chrXII","YLL010C (PSR1)","-",128981,128941,129024,83,"F-overlap-F",128941,129024,"chrXII"
"chrXII","YLL011W (SOF1)","+",129073,129134,129024,110,"F-overlap-F",129024,129134,"chrXII"
"chrXII","YLL012W (YEH1)","+",127342,127557,127244,313,"W-open-W",127244,127557,"chrXII"
"chrXII","YLL013C (PUF3)","-",121678,121665,121864,199,"F-close-F",121665,121864,"chrXII"
"chrXII","YLL014W (EMC6)","+",121798,121864,121665,199,"F-close-F",121665,121864,"chrXII"
"chrXII","YLL015W (BPT1)","+",121171,121347,121082,265,"F-open-W",121082,121347,"chrXII"
"chrXII","YLL018C (DPS1)","-",109749,109616,109772,156,"F-close-F",109616,109772,"chrXII"
"chrXII","YLL018C-A (COX19)","-",108070,107944,108114,170,"F-close-F",107944,108114,"chrXII"
"chrXII","YLL019C (KNS1 L124)","-",105409,105320,NA,NA,"-1_missing",105320,105740,"chrXII"
"chrXII","YLL021W (SPA2 FUS6 PEA1)","+",105464,105740,105320,420,"F-open-F",105320,105740,"chrXII"
"chrXII","YLL022C (HIF1)","-",98980,98899,99108,209,"W-close-F",98899,99108,"chrXII"
"chrXII","YLL023C (POM33)","-",97871,97886,97997,111,"F-overlap-W",97886,97997,"chrXII"
"chrXII","YLL024C (SSA2 YG102)","-",95432,95202,95627,425,"F-open-F",95202,95627,"chrXII"
"chrXII","YLL025W (PAU17)","+",95328,95627,95202,425,"F-open-F",95202,95627,"chrXII"
"chrXII","YLL026W (HSP104)","+",91439,91428,91260,168,"F-close-F",91260,91428,"chrXII"
"chrXII","YLL027W (ISA1)","+",88280,88426,88198,228,"F-open-F",88198,88426,"chrXII"
"chrXII","YLL028W (TPO1)","+",86955,87220,86879,341,"F-open-W",86879,87220,"chrXII"
"chrXII","YLL029W (FRA1 RUP2)","+",83814,83888,83690,198,"F-close-F",83690,83888,"chrXII"
"chrXII","YLL031C (GPI13 MPC1)","-",77059,76796,77085,289,"W-open-W",76796,77085,"chrXII"
"chrXII","YLL032C","-",73924,73769,73948,179,"W-close-W",73769,73948,"chrXII"
"chrXII","YLL033W (IRC19 GON2 RRG4)","+",74633,74695,74599,96,"F-overlap-W",74599,74695,"chrXII"
"chrXII","YLL034C (RIX7)","-",70488,70462,70720,258,"F-open-W",70462,70720,"chrXII"
"chrXII","YLL035W (GRC3)","+",70614,70720,70462,258,"W-open-F",70462,70720,"chrXII"
"chrXII","YLL036C (PRP19 PSO4)","-",66672,66494,66779,285,"W-open-W",66494,66779,"chrXII"
"chrXII","YLL037W","+",67672,67733,67571,162,"W-close-W",67571,67733,"chrXII"
"chrXII","YLL038C (ENT4)","-",65390,65259,65620,361,"F-open-F",65259,65620,"chrXII"
"chrXII","YLL039C (UBI4 SCD2 UB14)","-",63943,63954,64029,75,"F-overlap-F",63954,64029,"chrXII"
"chrXII","YLL040C (VPS13 SOI1 VPT2)","-",54145,53942,54255,313,"W-open-W",53942,54255,"chrXII"
"chrXII","YLL041C (SDH2 ACN17 SDHB)","-",52773,52779,52949,170,"W-close-F",52779,52949,"chrXII"
"chrXII","YLL042C (ATG10 APG10)","-",51985,51841,52222,381,"W-open-F",51841,52222,"chrXII"
"chrXII","YLL043W (FPS1)","+",52113,52222,51841,381,"F-open-W",51841,52222,"chrXII"
"chrXII","YLL045C (RPL8B KRB1 SCL41)","-",47774,47754,47944,190,"W-close-F",47754,47944,"chrXII"
"chrXII","YLL046C (RNP1)","-",46523,46410,46681,271,"F-open-W",46410,46681,"chrXII"
"chrXII","YLL047W","+",47155,47215,47037,178,"W-close-W",47037,47215,"chrXII"
"chrXII","YLL048C (YBT1 BAT1)","-",40646,40366,40689,323,"W-open-W",40366,40689,"chrXII"
"chrXII","YLL049W (LDB18)","+",41285,41381,41218,163,"F-close-W",41218,41381,"chrXII"
"chrXII","YLL050C (COF1)","-",39680,39498,39814,316,"F-open-W",39498,39814,"chrXII"
"chrXII","YLL051C (FRE6)","-",37154,NA,NA,NA,"+1_missing",36733,37244,"chrXII"
"chrXII","YLL054C","-",32313,32232,32431,199,"F-close-W",32232,32431,"chrXII"
"chrXII","YLL055W (YCT1)","+",31740,31873,31618,255,"W-open-W",31618,31873,"chrXII"
"chrXII","YLL056C","-",27288,27285,27465,180,"W-close-F",27285,27465,"chrXII"
"chrXII","YLL057C (JLP1)","-",25551,25511,25710,199,"W-close-F",25511,25710,"chrXII"
"chrXII","YLL058W","+",25401,25511,25314,197,"F-close-F",25314,25511,"chrXII"
"chrXII","YLL060C (GTT2)","-",20916,20858,21132,274,"W-open-W",20858,21132,"chrXII"
"chrXII","YLL061W (MMP1)","+",19801,19846,19749,97,"F-overlap-W",19749,19846,"chrXII"
"chrXII","YLL062C (MHT1)","-",16541,16542,16729,187,"W-close-W",16542,16729,"chrXII"
"chrXII","YLL063C (AYT1)","-",14489,14481,14666,185,"W-close-W",14481,14666,"chrXII"
"chrXII","YLR001C","-",151333,151280,151466,186,"W-close-W",151280,151466,"chrXII"
"chrXII","YLR002C (NOC3)","-",154263,154243,154412,169,"W-close-W",154243,154412,"chrXII"
"chrXII","YLR003C (CMS1)","-",156766,156621,156861,240,"W-open-W",156621,156861,"chrXII"
"chrXII","YLR004C (THI73)","-",157868,157733,157999,266,"W-open-W",157733,157999,"chrXII"
"chrXII","YLR005W (SSL1)","+",161621,161784,161566,218,"F-open-F",161566,161784,"chrXII"
"chrXII","YLR006C (SSK1)","-",161674,161566,161784,218,"F-open-F",161566,161784,"chrXII"
"chrXII","YLR007W (NSE1)","+",165465,165468,165269,199,"W-close-W",165269,165468,"chrXII"
"chrXII","YLR008C (PAM18 TIM14)","-",165334,165269,165468,199,"W-close-W",165269,165468,"chrXII"
"chrXII","YLR009W (RLP24)","+",167264,167433,167226,207,"F-close-W",167226,167433,"chrXII"
"chrXII","YLR010C (TEN1)","-",167177,167064,167226,162,"F-close-F",167064,167226,"chrXII"
"chrXII","YLR011W (LOT6)","+",169952,170029,169877,152,"F-close-W",169877,170029,"chrXII"
"chrXII","YLR012C","-",169912,169877,170029,152,"W-close-F",169877,170029,"chrXII"
"chrXII","YLR013W (GAT3)","+",171814,171830,171648,182,"F-close-F",171648,171830,"chrXII"
"chrXII","YLR014C (PPR1)","-",171974,171916,172151,235,"F-open-F",171916,172151,"chrXII"
"chrXII","YLR015W (BRE2 CPS60)","+",176940,177061,176916,145,"W-close-W",176916,177061,"chrXII"
"chrXII","YLR016C (PML1)","-",176706,176592,176761,169,"F-close-W",176592,176761,"chrXII"
"chrXII","YLR017W (MEU1)","+",178701,178808,178644,164,"F-close-W",178644,178808,"chrXII"
"chrXII","YLR018C (POM34)","-",178607,178498,178644,146,"F-close-W",178498,178644,"chrXII"
"chrXII","YLR019W (PSR2)","+",181735,181848,181571,277,"F-open-F",181571,181848,"chrXII"
"chrXII","YLR020C (YEH2)","-",181619,181571,181848,277,"F-open-F",181571,181848,"chrXII"
"chrXII","YLR021W (IRC25 DMP2 PBA3 POC3)","+",184210,184270,184186,84,"F-overlap-F",184186,184270,"chrXII"
"chrXII","YLR022C (SDO1)","-",184112,184064,184186,122,"F-close-F",184064,184186,"chrXII"
"chrXII","YLR023C (IZH3)","-",185090,184881,185120,239,"W-open-W",184881,185120,"chrXII"
"chrXII","YLR024C (UBR2)","-",187511,187289,187688,399,"W-open-W",187289,187688,"chrXII"
"chrXII","YLR025W (SNF7 DID1 RNS4 VPL5 VPS32)","+",195292,195581,195245,336,"F-open-F",195245,195581,"chrXII"
"chrXII","YLR026C (SED5)","-",195341,195245,195581,336,"F-open-F",195245,195581,"chrXII"
"chrXII","YLR027C (AAT2 ASP5)","-",196766,196531,196809,278,"F-open-W",196531,196809,"chrXII"
"chrXII","YLR028C (ADE16)","-",199444,199405,199478,73,"F-overlap-W",199405,199478,"chrXII"
"chrXII","YLR029C (RPL15A RPL10A)","-",201841,201713,201883,170,"F-close-F",201713,201883,"chrXII"
"chrXII","YLR030W","+",204805,204994,204700,294,"W-open-W",204700,204994,"chrXII"
"chrXII","YLR031W","+",204811,204994,204700,294,"W-open-W",204700,204994,"chrXII"
"chrXII","YLR032W (RAD5 REV2 SNM2)","+",208552,208764,208487,277,"W-open-W",208487,208764,"chrXII"
"chrXII","YLR033W (RSC58)","+",210462,210534,210420,114,"F-overlap-F",210420,210534,"chrXII"
"chrXII","YLR034C (SMF3)","-",210352,210252,210420,168,"F-close-F",210252,210420,"chrXII"
"chrXII","YLR035C (MLH2)","-",212103,212119,212398,279,"W-open-F",212119,212398,"chrXII"
"chrXII","YLR036C","-",221324,221269,221444,175,"F-close-W",221269,221444,"chrXII"
"chrXII","YLR037C (PAU23 DAN2)","-",222534,222378,222594,216,"F-open-W",222378,222594,"chrXII"
"chrXII","YLR038C (COX12)","-",224758,224726,224890,164,"W-close-F",224726,224890,"chrXII"
"chrXII","YLR040C","-",228770,228714,228914,200,"W-close-W",228714,228914,"chrXII"
"chrXII","YLR041W","+",230602,230843,230572,271,"W-open-W",230572,230843,"chrXII"
"chrXII","YLR042C","-",229860,229734,230059,325,"W-open-F",229734,230059,"chrXII"
"chrXII","YLR043C (TRX1 LMA1)","-",231573,231583,231726,143,"F-close-W",231583,231726,"chrXII"
"chrXII","YLR044C (PDC1)","-",232313,232291,232468,177,"W-close-W",232291,232468,"chrXII"
"chrXII","YLR045C (STU2)","-",234895,234858,235046,188,"F-close-F",234858,235046,"chrXII"
"chrXII","YLR046C (RLA1)","-",237952,237728,238032,304,"W-open-W",237728,238032,"chrXII"
"chrXII","YLR047C (FRE8)","-",238959,238830,239021,191,"F-close-W",238830,239021,"chrXII"
"chrXII","YLR048W (RPS0B NAB1B YST2)","+",243574,243602,243468,134,"F-close-F",243468,243602,"chrXII"
"chrXII","YLR049C","-",243783,243602,243852,250,"F-open-F",243602,243852,"chrXII"
"chrXII","YLR050C","-",245495,245341,245608,267,"W-open-W",245341,245608,"chrXII"
"chrXII","YLR051C (FCF2)","-",246223,246095,246304,209,"F-close-W",246095,246304,"chrXII"
"chrXII","YLR052W (IES3)","+",248091,248186,248069,117,"F-overlap-W",248069,248186,"chrXII"
"chrXII","YLR053C","-",247995,247866,248069,203,"F-close-W",247866,248069,"chrXII"
"chrXII","YLR054C (OSW2)","-",248484,248388,248610,222,"W-open-W",248388,248610,"chrXII"
"chrXII","YLR055C (SPT8)","-",251234,251041,251352,311,"W-open-W",251041,251352,"chrXII"
"chrXII","YLR056W (ERG3 PSO6 SYR1)","+",255085,255279,255033,246,"W-open-W",255033,255279,"chrXII"
"chrXII","YLR057W","+",257945,258028,257896,132,"F-close-W",257896,258028,"chrXII"
"chrXII","YLR058C (SHM2 SHMT2)","-",257849,257780,257896,116,"F-overlap-F",257780,257896,"chrXII"
"chrXII","YLR059C (REX2 YNT20)","-",259554,259500,259620,120,"F-close-F",259500,259620,"chrXII"
"chrXII","YLR060W (FRS1)","+",262872,NA,NA,NA,"+1_missing",262825,263189,"chrXII"
"chrXII","YLR061W (RPL22A)","+",264039,264257,263835,422,"W-open-W",263835,264257,"chrXII"
"chrXII","YLR062C (BUD28)","-",263147,NA,NA,NA,"+1_missing",262825,263189,"chrXII"
"chrXII","YLR063W","+",265426,265470,265204,266,"W-open-W",265204,265470,"chrXII"
"chrXII","YLR064W (PER33)","+",266361,266408,266231,177,"W-close-W",266231,266408,"chrXII"
"chrXII","YLR065C","-",266261,266231,266408,177,"W-close-W",266231,266408,"chrXII"
"chrXII","YLR066W (SPC3)","+",267825,267861,267671,190,"W-close-W",267671,267861,"chrXII"
"chrXII","YLR067C (PET309)","-",267734,267671,267861,190,"W-close-W",267671,267861,"chrXII"
"chrXII","YLR068W (FYV7)","+",271575,271677,271496,181,"F-close-F",271496,271677,"chrXII"
"chrXII","YLR069C (MEF1)","-",271486,271496,271677,181,"F-close-F",271496,271677,"chrXII"
"chrXII","YLR070C (XYL2)","-",274007,273882,274160,278,"W-open-W",273882,274160,"chrXII"
"chrXII","YLR071C (RGR1 MED14)","-",275238,275152,275277,125,"F-close-F",275152,275277,"chrXII"
"chrXII","YLR072W","+",280996,281071,280877,194,"W-close-W",280877,281071,"chrXII"
"chrXII","YLR073C (RFU1)","-",280940,280877,281071,194,"W-close-W",280877,281071,"chrXII"
"chrXII","YLR074C (BUD20)","-",281883,281728,281997,269,"W-open-W",281728,281997,"chrXII"
"chrXII","YLR075W (RPL10 GRC5 QSR1)","+",283733,283770,283531,239,"F-open-F",283531,283770,"chrXII"
"chrXII","YLR076C","-",282902,282891,283054,163,"W-close-W",282891,283054,"chrXII"
"chrXII","YLR077W (FMP25 BCA1)","+",285780,285884,285708,176,"W-close-W",285708,285884,"chrXII"
"chrXII","YLR078C (BOS1 SEC32)","-",285659,285583,285708,125,"W-close-F",285583,285708,"chrXII"
"chrXII","YLR079W (SIC1 SDB25)","+",287828,288003,287802,201,"W-close-W",287802,288003,"chrXII"
"chrXII","YLR080W (EMP46)","+",289331,289501,289254,247,"W-open-W",289254,289501,"chrXII"
"chrXII","YLR081W (GAL2)","+",292153,292253,292062,191,"F-close-W",292062,292253,"chrXII"
"chrXII","YLR082C (SRL2)","-",292045,292062,292253,191,"W-close-F",292062,292253,"chrXII"
"chrXII","YLR083C (EMP70 TMN1 p24a)","-",293930,293832,294042,210,"W-close-W",293832,294042,"chrXII"
"chrXII","YLR084C (RAX2)","-",296498,296472,296663,191,"W-close-W",296472,296663,"chrXII"
"chrXII","YLR085C (ARP6)","-",300570,300344,300658,314,"W-open-W",300344,300658,"chrXII"
"chrXII","YLR086W (SMC4)","+",306718,306773,306694,79,"F-overlap-F",306694,306773,"chrXII"
"chrXII","YLR087C (CSF1)","-",306747,306694,306773,79,"F-overlap-F",306694,306773,"chrXII"
"chrXII","YLR088W (GAA1 END2)","+",318121,318183,317979,204,"F-close-F",317979,318183,"chrXII"
"chrXII","YLR089C (ALT1)","-",318114,317979,318183,204,"F-close-F",317979,318183,"chrXII"
"chrXII","YLR090W (XDJ1)","+",322207,322290,322043,247,"W-open-F",322043,322290,"chrXII"
"chrXII","YLR091W (GEP5 RRG5)","+",323442,323523,323400,123,"W-close-F",323400,323523,"chrXII"
"chrXII","YLR092W (SUL2)","+",326412,326416,326337,79,"F-overlap-F",326337,326416,"chrXII"
"chrXII","YLR093C (NYV1 MAM2)","-",326321,326337,326416,79,"F-overlap-F",326337,326416,"chrXII"
"chrXII","YLR094C (GIS3)","-",327611,327456,327744,288,"W-open-W",327456,327744,"chrXII"
"chrXII","YLR095C (IOC2)","-",329619,NA,NA,NA,"+1_missing",329279,329731,"chrXII"
"chrXII","YLR096W (KIN2)","+",336154,336278,335988,290,"F-open-W",335988,336278,"chrXII"
"chrXII","YLR097C (HRT3)","-",336138,335988,336278,290,"W-open-F",335988,336278,"chrXII"
"chrXII","YLR098C (CHA4 SIL2 SIL3)","-",337382,337274,337520,246,"W-open-W",337274,337520,"chrXII"
"chrXII","YLR099C (ICT1)","-",339633,339648,339823,175,"W-close-F",339648,339823,"chrXII"
"chrXII","YLR099W-A","+",341649,341762,341628,134,"F-close-F",341628,341762,"chrXII"
"chrXII","YLR100W (ERG27)","+",342946,343020,342862,158,"W-close-W",342862,343020,"chrXII"
"chrXII","YLR102C (APC9)","-",342855,342862,343020,158,"W-close-W",342862,343020,"chrXII"
"chrXII","YLR103C (CDC45 SLD4)","-",343911,343745,343994,249,"W-open-W",343745,343994,"chrXII"
"chrXII","YLR104W (LCL2)","+",347048,347113,346924,189,"W-close-W",346924,347113,"chrXII"
"chrXII","YLR105C (SEN2)","-",346958,346924,347113,189,"W-close-W",346924,347113,"chrXII"
"chrXII","YLR106C (MDN1 REA1)","-",348937,348876,349067,191,"W-close-W",348876,349067,"chrXII"
"chrXII","YLR107W (REX3)","+",365434,365585,365347,238,"F-open-F",365347,365585,"chrXII"
"chrXII","YLR108C","-",366525,366370,366580,210,"W-close-W",366370,366580,"chrXII"
"chrXII","YLR109W (AHP1)","+",369379,NA,NA,NA,"+1_missing",369318,369773,"chrXII"
"chrXII","YLR110C (CCW12)","-",369611,369318,369773,455,"W-open-W",369318,369773,"chrXII"
"chrXII","YLR111W","+",371483,371474,NA,NA,"-1_missing",371147,371474,"chrXII"
"chrXII","YLR112W","+",371515,371683,371474,209,"F-close-W",371474,371683,"chrXII"
"chrXII","YLR113W (HOG1 SSK3)","+",373061,373151,372994,157,"W-close-W",372994,373151,"chrXII"
"chrXII","YLR114C (AVL9)","-",374547,374372,374589,217,"W-open-F",374372,374589,"chrXII"
"chrXII","YLR115W (CFT2 YDH1)","+",380712,380878,380586,292,"W-open-W",380586,380878,"chrXII"
"chrXII","YLR116W (MSL5)","+",382454,382534,382393,141,"F-close-F",382393,382534,"chrXII"
"chrXII","YLR117C (CLF1 NTC77 SYF3)","-",382347,382284,382393,109,"F-overlap-F",382284,382393,"chrXII"
"chrXII","YLR118C (APT1)","-",384622,384507,384754,247,"W-open-W",384507,384754,"chrXII"
"chrXII","YLR120C (YPS1 YAP3)","-",386166,386115,386330,215,"F-close-W",386115,386330,"chrXII"
"chrXII","YLR120W-A","+",388968,389028,388850,178,"F-close-W",388850,389028,"chrXII"
"chrXII","YLR121C (YPS3 YPS4)","-",388601,388595,388850,255,"F-open-W",388595,388850,"chrXII"
"chrXII","YLR122C","-",390908,390642,390970,328,"W-open-W",390642,390970,"chrXII"
"chrXII","YLR125W","+",394790,394897,394710,187,"F-close-W",394710,394897,"chrXII"
"chrXII","YLR126C","-",394534,394484,394589,105,"W-overlap-F",394484,394589,"chrXII"
"chrXII","YLR127C (APC2 RSI1 TID2)","-",395560,395554,395828,274,"W-open-F",395554,395828,"chrXII"
"chrXII","YLR128W (DCN1)","+",399638,399672,399364,308,"W-open-W",399364,399672,"chrXII"
"chrXII","YLR129W (DIP2 UTP12)","+",402601,402657,402575,82,"F-overlap-W",402575,402657,"chrXII"
"chrXII","YLR130C (ZRT2)","-",402726,402657,402764,107,"F-overlap-W",402657,402764,"chrXII"
"chrXII","YLR131C (ACE2)","-",404436,404275,404559,284,"W-open-F",404275,404559,"chrXII"
"chrXII","YLR132C","-",406932,406879,407052,173,"W-close-W",406879,407052,"chrXII"
"chrXII","YLR133W (CKI1)","+",410646,410652,410553,99,"W-overlap-F",410553,410652,"chrXII"
"chrXII","YLR134W (PDC5)","+",412537,412660,412498,162,"F-close-W",412498,412660,"chrXII"
"chrXII","YLR135W (SLX4)","+",415683,415817,415583,234,"W-open-W",415583,415817,"chrXII"
"chrXII","YLR136C (TIS11 CTH2)","-",415555,415390,415583,193,"W-close-W",415390,415583,"chrXII"
"chrXII","YLR137W","+",418158,418320,418030,290,"W-open-W",418030,418320,"chrXII"
"chrXII","YLR138W (NHA1)","+",421467,421511,421386,125,"F-close-F",421386,421511,"chrXII"
"chrXII","YLR139C (SLS1)","-",421380,421386,421511,125,"F-close-F",421386,421511,"chrXII"
"chrXII","YLR142W (PUT1)","+",426662,426819,426619,200,"W-close-W",426619,426819,"chrXII"
"chrXII","YLR143W","+",429482,429493,429326,167,"F-close-F",429326,429493,"chrXII"
"chrXII","YLR144C (ACF2 ENG2 PCA1)","-",429552,429493,429579,86,"F-overlap-F",429493,429579,"chrXII"
"chrXII","YLR145W (RMP1)","+",432824,432886,432708,178,"W-close-W",432708,432886,"chrXII"
"chrXII","YLR146C (SPE4)","-",432737,432708,432886,178,"W-close-W",432708,432886,"chrXII"
"chrXII","YLR146W-A","+",434153,434260,434087,173,"W-close-W",434087,434260,"chrXII"
"chrXII","YLR147C (SMD3 SLT16)","-",434050,433926,434087,161,"W-close-W",433926,434087,"chrXII"
"chrXII","YLR148W (PEP3 VAM8 VPS18 VPT18)","+",437531,437671,437489,182,"W-close-F",437489,437671,"chrXII"
"chrXII","YLR149C","-",437442,437317,437489,172,"W-close-W",437317,437489,"chrXII"
"chrXII","YLR149C-A","-",440239,NA,NA,NA,"+1_missing",439848,440334,"chrXII"
"chrXII","YLR150W (STM1 MPT4)","+",441445,441573,441373,200,"F-close-F",441373,441573,"chrXII"
"chrXII","YLR151C (PCD1)","-",441442,441373,441573,200,"F-close-F",441373,441573,"chrXII"
"chrXII","YLR152C","-",442872,442693,442922,229,"W-open-W",442693,442922,"chrXII"
"chrXII","YLR153C (ACS2)","-",445263,445109,445317,208,"W-close-F",445109,445317,"chrXII"
"chrXII","YLR154C (RNH203)","-",447909,447684,447998,314,"W-open-F",447684,447998,"chrXII"
"chrXII","YLR154C-G","-",462085,NA,NA,NA,"+1_missing",460533,490503,"chrXII"
"chrXII","YLR154W-C (TAR1 YLR154W-A)","+",455161,NA,NA,NA,"+1_missing",451182,459753,"chrXII"
"chrXII","YLR155C (ASP3-1 ASP3)","-",469227,NA,NA,NA,"+1_missing",460533,490503,"chrXII"
"chrXII","YLR157C (ASP3-2 ASP3)","-",472874,NA,NA,NA,"+1_missing",460533,490503,"chrXII"
"chrXII","YLR158C (ASP3-3 ASP3)","-",482436,NA,NA,NA,"+1_missing",460533,490503,"chrXII"
"chrXII","YLR160C (ASP3-4 ASP3)","-",486116,NA,NA,NA,"+1_missing",460533,490503,"chrXII"
"chrXII","YLR162W","+",489948,NA,NA,NA,"+1_missing",460533,490503,"chrXII"
"chrXII","YLR163C (MAS1 MIF1)","-",491755,491762,491894,132,"F-close-F",491762,491894,"chrXII"
"chrXII","YLR164W","+",494490,494546,494378,168,"W-close-W",494378,494546,"chrXII"
"chrXII","YLR165C (PUS5)","-",494408,494378,494546,168,"W-close-W",494378,494546,"chrXII"
"chrXII","YLR166C (SEC10)","-",495370,495227,495446,219,"W-open-F",495227,495446,"chrXII"
"chrXII","YLR167W (RPS31 RPS37 UBI3)","+",499465,499594,499404,190,"W-close-W",499404,499594,"chrXII"
"chrXII","YLR168C (UPS2 AIM30 GEP1 MSF1 MSF1')","-",499453,499404,499594,190,"W-close-W",499404,499594,"chrXII"
"chrXII","YLR169W","+",501092,501318,501054,264,"W-open-W",501054,501318,"chrXII"
"chrXII","YLR170C (APS1 YAP19)","-",500325,500277,NA,NA,"-1_missing",500277,500702,"chrXII"
"chrXII","YLR172C (DPH5)","-",501157,501054,501318,264,"W-open-W",501054,501318,"chrXII"
"chrXII","YLR173W","+",504341,504418,504061,357,"W-open-W",504061,504418,"chrXII"
"chrXII","YLR174W (IDP2)","+",505928,506120,505768,352,"W-open-W",505768,506120,"chrXII"
"chrXII","YLR175W (CBF5)","+",507708,507799,507557,242,"W-open-F",507557,507799,"chrXII"
"chrXII","YLR176C (RFX1 CRT1)","-",507698,507557,507799,242,"F-open-W",507557,507799,"chrXII"
"chrXII","YLR177W","+",513012,513217,512899,318,"W-open-W",512899,513217,"chrXII"
"chrXII","YLR178C (TFS1 DKA1)","-",513103,512899,513217,318,"W-open-W",512899,513217,"chrXII"
"chrXII","YLR179C","-",514014,513861,514047,186,"F-close-W",513861,514047,"chrXII"
"chrXII","YLR180W (SAM1 ETH10)","+",516663,516729,516486,243,"F-open-F",516486,516729,"chrXII"
"chrXII","YLR181C (VTA1)","-",516561,516486,516729,243,"F-open-F",516486,516729,"chrXII"
"chrXII","YLR182W (SWI6 PSL8 SDS11)","+",520479,520600,520425,175,"F-close-F",520425,520600,"chrXII"
"chrXII","YLR183C (TOS4)","-",520393,520329,520425,96,"F-overlap-F",520329,520425,"chrXII"
"chrXII","YLR185W (RPL37A)","+",523385,523611,523322,289,"W-open-W",523322,523611,"chrXII"
"chrXII","YLR186W (EMG1 NEP1)","+",524468,524458,524276,182,"F-close-F",524276,524458,"chrXII"
"chrXII","YLR187W (SKG3)","+",528050,528186,528020,166,"F-close-F",528020,528186,"chrXII"
"chrXII","YLR188W (MDL1)","+",530588,530569,530452,117,"F-overlap-F",530452,530569,"chrXII"
"chrXII","YLR189C (ATG26 UGT51)","-",530692,530649,530825,176,"W-close-F",530649,530825,"chrXII"
"chrXII","YLR190W (MMR1)","+",537070,537287,536998,289,"W-open-W",536998,537287,"chrXII"
"chrXII","YLR191W (PEX13 PAS20)","+",538520,538595,538463,132,"W-close-F",538463,538595,"chrXII"
"chrXII","YLR192C (HCR1)","-",538558,538463,538595,132,"F-close-W",538463,538595,"chrXII"
"chrXII","YLR193C (UPS1)","-",539834,539635,539901,266,"W-open-W",539635,539901,"chrXII"
"chrXII","YLR194C","-",540742,540528,540820,292,"W-open-W",540528,540820,"chrXII"
"chrXII","YLR195C (NMT1 CDC72)","-",541828,541739,541994,255,"F-open-W",541739,541994,"chrXII"
"chrXII","YLR196W (PWP1)","+",545830,546101,545749,352,"F-open-W",545749,546101,"chrXII"
"chrXII","YLR197W (NOP56 SIK1)","+",547795,547929,547690,239,"F-open-F",547690,547929,"chrXII"
"chrXII","YLR198C","-",547142,547057,547214,157,"F-close-F",547057,547214,"chrXII"
"chrXII","YLR199C (PBA1 POC1)","-",547708,547690,547929,239,"F-open-F",547690,547929,"chrXII"
"chrXII","YLR200W (YKE2 GIM1 PFD6)","+",549490,549507,549339,168,"W-close-W",549339,549507,"chrXII"
"chrXII","YLR201C (COQ9 FMP53)","-",549411,549339,549507,168,"W-close-W",549339,549507,"chrXII"
"chrXII","YLR203C (MSS51)","-",550639,550520,550701,181,"W-close-F",550520,550701,"chrXII"
"chrXII","YLR204W (QRI5 COX24)","+",552758,552807,552607,200,"W-close-W",552607,552807,"chrXII"
"chrXII","YLR205C (HMX1)","-",552649,552607,552807,200,"W-close-W",552607,552807,"chrXII"
"chrXII","YLR206W (ENT2)","+",556561,556556,556358,198,"W-close-W",556358,556556,"chrXII"
"chrXII","YLR207W (HRD3)","+",559347,559500,559217,283,"W-open-W",559217,559500,"chrXII"
"chrXII","YLR208W (SEC13 ANU3)","+",560714,560705,560624,81,"F-overlap-F",560624,560705,"chrXII"
"chrXII","YLR209C (PNP1)","-",560668,560624,560705,81,"F-overlap-F",560624,560705,"chrXII"
"chrXII","YLR210W (CLB4)","+",563563,563610,563534,76,"F-overlap-F",563534,563610,"chrXII"
"chrXII","YLR211C","-",563429,563306,563534,228,"F-open-F",563306,563534,"chrXII"
"chrXII","YLR212C (TUB4)","-",564713,564560,564787,227,"W-open-W",564560,564787,"chrXII"
"chrXII","YLR213C (CRR1)","-",566515,566268,566575,307,"W-open-W",566268,566575,"chrXII"
"chrXII","YLR214W (FRE1)","+",570758,570849,570585,264,"W-open-F",570585,570849,"chrXII"
"chrXII","YLR215C (CDC123)","-",570671,570585,570849,264,"F-open-W",570585,570849,"chrXII"
"chrXII","YLR216C (CPR6 CYP40)","-",571990,571850,572068,218,"F-open-W",571850,572068,"chrXII"
"chrXII","YLR217W","+",573475,573595,573444,151,"W-close-W",573444,573595,"chrXII"
"chrXII","YLR218C (COA4 CMC3)","-",573362,573209,573444,235,"W-open-W",573209,573444,"chrXII"
"chrXII","YLR219W (MSC3)","+",576496,576730,576352,378,"W-open-W",576352,576730,"chrXII"
"chrXII","YLR220W (CCC1)","+",577968,578037,577724,313,"W-open-W",577724,578037,"chrXII"
"chrXII","YLR221C (RSA3)","-",578137,578037,578215,178,"F-close-W",578037,578215,"chrXII"
"chrXII","YLR222C (UTP13)","-",579220,579014,579280,266,"W-open-W",579014,579280,"chrXII"
"chrXII","YLR223C (IFH1)","-",582064,582013,582198,185,"W-close-W",582013,582198,"chrXII"
"chrXII","YLR224W","+",587665,587753,587502,251,"W-open-W",587502,587753,"chrXII"
"chrXII","YLR225C","-",587565,587502,587753,251,"W-open-W",587502,587753,"chrXII"
"chrXII","YLR226W (BUR2 CST4)","+",591052,591090,591009,81,"W-overlap-F",591009,591090,"chrXII"
"chrXII","YLR227C (ADY4)","-",590475,590464,590547,83,"W-overlap-F",590464,590547,"chrXII"
"chrXII","YLR228C (ECM22)","-",599902,599756,599951,195,"F-close-W",599756,599951,"chrXII"
"chrXII","YLR229C (CDC42)","-",604122,604011,604329,318,"W-open-F",604011,604329,"chrXII"
"chrXII","YLR230W","+",605014,605202,604968,234,"W-open-W",604968,605202,"chrXII"
"chrXII","YLR231C (BNA5)","-",605655,605637,605806,169,"W-close-W",605637,605806,"chrXII"
"chrXII","YLR233C (EST1)","-",607143,607117,607359,242,"F-open-W",607117,607359,"chrXII"
"chrXII","YLR234W (TOP3 EDR1)","+",612267,612296,612032,264,"F-open-W",612032,612296,"chrXII"
"chrXII","YLR237W (THI7 THI10)","+",614349,614368,614148,220,"F-open-F",614148,614368,"chrXII"
"chrXII","YLR238W (FAR10)","+",616307,616340,616267,73,"F-overlap-F",616267,616340,"chrXII"
"chrXII","YLR239C (LIP2)","-",616226,616147,616267,120,"F-close-F",616147,616267,"chrXII"
"chrXII","YLR240W (VPS34 END12 PEP15 STT8 VPL7 VPS7 VPT29)","+",620319,620463,620211,252,"W-open-W",620211,620463,"chrXII"
"chrXII","YLR241W","+",622919,622962,622753,209,"W-close-F",622753,622962,"chrXII"
"chrXII","YLR242C (ARV1)","-",622885,622753,622962,209,"F-close-W",622753,622962,"chrXII"
"chrXII","YLR243W","+",625115,625166,624995,171,"F-close-W",624995,625166,"chrXII"
"chrXII","YLR244C (MAP1)","-",625105,624995,625166,171,"W-close-F",624995,625166,"chrXII"
"chrXII","YLR245C (CDD1)","-",626391,626292,626586,294,"W-open-W",626292,626586,"chrXII"
"chrXII","YLR246W (ERF2)","+",628267,628491,628112,379,"W-open-F",628112,628491,"chrXII"
"chrXII","YLR247C (IRC20)","-",628579,628491,628759,268,"F-open-F",628491,628759,"chrXII"
"chrXII","YLR248W (RCK2 CLK1 CMK3)","+",636221,636202,636012,190,"W-close-W",636012,636202,"chrXII"
"chrXII","YLR249W (YEF3 TEF3)","+",640043,640305,639964,341,"F-open-W",639964,640305,"chrXII"
"chrXII","YLR250W (SSP120)","+",641153,641158,640983,175,"W-close-F",640983,641158,"chrXII"
"chrXII","YLR251W (SYM1)","+",642068,642181,642026,155,"W-close-W",642026,642181,"chrXII"
"chrXII","YLR252W","+",642422,642597,642349,248,"W-open-W",642349,642597,"chrXII"
"chrXII","YLR253W","+",644428,644532,644195,337,"W-open-W",644195,644532,"chrXII"
"chrXII","YLR254C (NDL1)","-",644327,644195,644532,337,"W-open-W",644195,644532,"chrXII"
"chrXII","YLR255C","-",645525,645477,645546,69,"W-overlap-F",645477,645546,"chrXII"
"chrXII","YLR256W (HAP1 CYP1)","+",651178,NA,NA,NA,"+1_missing",650668,656811,"chrXII"
"chrXII","YLR257W","+",659892,660060,659765,295,"F-open-W",659765,660060,"chrXII"
"chrXII","YLR258W (GSY2)","+",663192,663248,663073,175,"F-close-F",663073,663248,"chrXII"
"chrXII","YLR259C (HSP60 CPN60 MIF4 MNA2)","-",663151,663073,663248,175,"F-close-F",663073,663248,"chrXII"
"chrXII","YLR260W (LCB5)","+",668075,668058,667861,197,"F-close-F",667861,668058,"chrXII"
"chrXII","YLR261C (VPS63)","-",668180,668128,668276,148,"F-close-F",668128,668276,"chrXII"
"chrXII","YLR262C (YPT6)","-",668180,668128,668276,148,"F-close-F",668128,668276,"chrXII"
"chrXII","YLR262C-A (TMA7 RBF7)","-",669359,669369,669518,149,"W-close-F",669369,669518,"chrXII"
"chrXII","YLR263W (RED1)","+",672897,673164,672782,382,"W-open-F",672782,673164,"chrXII"
"chrXII","YLR264C-A","-",673375,673268,673506,238,"F-open-W",673268,673506,"chrXII"
"chrXII","YLR264W (RPS28B RPS33B)","+",673985,674273,673860,413,"F-open-W",673860,674273,"chrXII"
"chrXII","YLR265C (NEJ1 LIF2)","-",674265,674273,674448,175,"W-close-W",674273,674448,"chrXII"
"chrXII","YLR266C (PDR8)","-",675586,675443,675716,273,"W-open-W",675443,675716,"chrXII"
"chrXII","YLR267W (BOP2)","+",680021,680201,679913,288,"W-open-W",679913,680201,"chrXII"
"chrXII","YLR268W (SEC22 SLY2 TSL26)","+",680965,681105,680837,268,"W-open-F",680837,681105,"chrXII"
"chrXII","YLR270W (DCS1 DcpS)","+",682444,682459,682268,191,"W-close-W",682268,682459,"chrXII"
"chrXII","YLR271W","+",683677,683664,683508,156,"W-close-F",683508,683664,"chrXII"
"chrXII","YLR272C (YCS4 LOC7)","-",683591,683508,683664,156,"F-close-W",683508,683664,"chrXII"
"chrXII","YLR273C (PIG1)","-",688924,688843,689113,270,"W-open-F",688843,689113,"chrXII"
"chrXII","YLR274W (MCM5 BOB1 CDC46)","+",694014,694127,693938,189,"F-close-W",693938,694127,"chrXII"
"chrXII","YLR275W (SMD2)","+",695056,695053,NA,NA,"-1_missing",694717,695053,"chrXII"
"chrXII","YLR276C (DBP9)","-",694971,694717,695053,336,"F-open-W",694717,695053,"chrXII"
"chrXII","YLR277C (YSH1 BRR5)","-",697093,696918,697157,239,"W-open-W",696918,697157,"chrXII"
"chrXII","YLR278C","-",699746,699603,NA,NA,"-1_missing",699603,700077,"chrXII"
"chrXII","YLR283W","+",706223,706284,706071,213,"F-close-W",706071,706284,"chrXII"
"chrXII","YLR284C (ECI1)","-",706113,706071,706284,213,"W-close-F",706071,706284,"chrXII"
"chrXII","YLR285W (NNT1)","+",708322,708327,708205,122,"F-close-F",708205,708327,"chrXII"
"chrXII","YLR286C (CTS1)","-",708392,708400,708550,150,"W-close-F",708400,708550,"chrXII"
"chrXII","YLR286W-A","+",709068,709218,709008,210,"F-close-W",709008,709218,"chrXII"
"chrXII","YLR287C","-",710763,710554,NA,NA,"-1_missing",710554,711220,"chrXII"
"chrXII","YLR287C-A (RPS30A)","-",712342,712337,712505,168,"W-close-F",712337,712505,"chrXII"
"chrXII","YLR288C (MEC3 PIP3 PSO9)","-",713343,NA,NA,NA,"+1_missing",712650,713664,"chrXII"
"chrXII","YLR289W (GUF1)","+",717143,717160,717054,106,"F-overlap-F",717054,717160,"chrXII"
"chrXII","YLR290C","-",717031,716949,717054,105,"F-overlap-W",716949,717054,"chrXII"
"chrXII","YLR291C (GCD7)","-",718166,717957,718374,417,"W-open-F",717957,718374,"chrXII"
"chrXII","YLR292C (SEC72 SEC67 SIM2)","-",719634,719451,719709,258,"W-open-W",719451,719709,"chrXII"
"chrXII","YLR293C (GSP1 CNR1 CST17)","-",720636,720624,720809,185,"W-close-W",720624,720809,"chrXII"
"chrXII","YLR295C (ATP14)","-",721767,721784,721923,139,"F-close-F",721784,721923,"chrXII"
"chrXII","YLR296W","+",723845,723863,723775,88,"F-overlap-F",723775,723863,"chrXII"
"chrXII","YLR297W","+",724729,724903,724706,197,"F-close-W",724706,724903,"chrXII"
"chrXII","YLR298C (YHC1)","-",724645,724512,724706,194,"F-close-F",724512,724706,"chrXII"
"chrXII","YLR299W (ECM38 CIS2)","+",728180,NA,NA,NA,"+1_missing",728085,728725,"chrXII"
"chrXII","YLR300W (EXG1 BGL1)","+",730542,730825,730450,375,"W-open-W",730450,730825,"chrXII"
"chrXII","YLR301W","+",731680,731720,731638,82,"F-overlap-F",731638,731720,"chrXII"
"chrXII","YLR303W (MET17 MET15 MET25)","+",733978,734006,733890,116,"F-overlap-W",733890,734006,"chrXII"
"chrXII","YLR304C (ACO1 GLU1)","-",735001,NA,NA,NA,"+1_missing",734651,735061,"chrXII"
"chrXII","YLR305C (STT4)","-",738109,738102,738297,195,"W-close-F",738102,738297,"chrXII"
"chrXII","YLR306W (UBC12)","+",744961,744981,744797,184,"W-close-W",744797,744981,"chrXII"
"chrXII","YLR307C-A","-",746620,746464,746724,260,"F-open-W",746464,746724,"chrXII"
"chrXII","YLR307W (CDA1)","+",746629,746724,746464,260,"W-open-F",746464,746724,"chrXII"
"chrXII","YLR308W (CDA2)","+",749005,749002,748755,247,"F-open-F",748755,749002,"chrXII"
"chrXII","YLR309C (IMH1 SYS3)","-",748979,748755,749002,247,"F-open-F",748755,749002,"chrXII"
"chrXII","YLR310C (CDC25 CDC25' CTN1)","-",751981,751769,752098,329,"F-open-W",751769,752098,"chrXII"
"chrXII","YLR312W-A (MRPL15)","+",760363,760348,760173,175,"W-close-F",760173,760348,"chrXII"
"chrXII","YLR313C (SPH1 YLR312C-B)","-",760293,760173,760348,175,"F-close-W",760173,760348,"chrXII"
"chrXII","YLR314C (CDC3)","-",762471,762369,762629,260,"W-open-F",762369,762629,"chrXII"
"chrXII","YLR315W (NKP2)","+",765409,765503,765338,165,"W-close-W",765338,765503,"chrXII"
"chrXII","YLR316C (TAD3)","-",765198,765154,765338,184,"W-close-W",765154,765338,"chrXII"
"chrXII","YLR317W","+",766229,766341,766196,145,"F-close-W",766196,766341,"chrXII"
"chrXII","YLR318W (EST2 TERT)","+",769218,769302,768995,307,"F-open-F",768995,769302,"chrXII"
"chrXII","YLR319C (BUD6 AIP3)","-",769136,768995,769302,307,"F-open-F",768995,769302,"chrXII"
"chrXII","YLR320W (MMS22 SLM2)","+",776364,776424,776326,98,"F-overlap-W",776326,776424,"chrXII"
"chrXII","YLR321C (SFH1)","-",776275,776244,776326,82,"F-overlap-F",776244,776326,"chrXII"
"chrXII","YLR323C (CWC24)","-",777977,777822,778115,293,"W-open-W",777822,778115,"chrXII"
"chrXII","YLR324W (PEX30)","+",780876,780908,780724,184,"W-close-F",780724,780908,"chrXII"
"chrXII","YLR325C (RPL38)","-",780902,780908,781073,165,"W-close-F",780908,781073,"chrXII"
"chrXII","YLR326W","+",783024,783132,782950,182,"F-close-F",782950,783132,"chrXII"
"chrXII","YLR327C (TMA10 RBF9 SFL2)","-",782955,782950,783132,182,"F-close-F",782950,783132,"chrXII"
"chrXII","YLR328W (NMA1)","+",786289,786581,786181,400,"F-open-W",786181,786581,"chrXII"
"chrXII","YLR329W (REC102)","+",787370,787397,787207,190,"W-close-F",787207,787397,"chrXII"
"chrXII","YLR330W (CHS5 CAL3)","+",789824,NA,NA,NA,"+1_missing",789753,790282,"chrXII"
"chrXII","YLR331C (JIP3)","-",790093,NA,NA,NA,"+1_missing",789753,790282,"chrXII"
"chrXII","YLR332W (MID2 KAI1)","+",791995,792082,791891,191,"W-close-W",791891,792082,"chrXII"
"chrXII","YLR333C (RPS25B)","-",795416,795160,795453,293,"W-open-W",795160,795453,"chrXII"
"chrXII","YLR335W (NUP2)","+",799688,799774,799585,189,"F-close-F",799585,799774,"chrXII"
"chrXII","YLR336C (SGD1)","-",799620,799585,799774,189,"F-close-F",799585,799774,"chrXII"
"chrXII","YLR337C (VRP1 END5 MDP2 YLR337W)","-",802528,802388,802678,290,"W-open-W",802388,802678,"chrXII"
"chrXII","YLR339C","-",805783,805533,805854,321,"W-open-W",805533,805854,"chrXII"
"chrXII","YLR340W (RPP0 RPL10E)","+",806910,807095,806750,345,"W-open-F",806750,807095,"chrXII"
"chrXII","YLR342W (FKS1 CND1 CWH53 ETG1 GSC1 PBR1)","+",815646,815712,815605,107,"W-overlap-F",815605,815712,"chrXII"
"chrXII","YLR342W-A","+",816199,816201,NA,NA,"-1_missing",815712,816201,"chrXII"
"chrXII","YLR343W (GAS2)","+",817826,818123,817657,466,"W-open-F",817657,818123,"chrXII"
"chrXII","YLR344W (RPL26A)","+",820247,820292,820216,76,"W-overlap-F",820216,820292,"chrXII"
"chrXII","YLR345W","+",822123,822237,822004,233,"F-open-F",822004,822237,"chrXII"
"chrXII","YLR346C","-",822134,822004,822237,233,"F-open-F",822004,822237,"chrXII"
"chrXII","YLR347C (KAP95 RSL1)","-",823552,NA,NA,NA,"+1_missing",823182,823693,"chrXII"
"chrXII","YLR348C (DIC1)","-",826907,826870,827074,204,"F-close-W",826870,827074,"chrXII"
"chrXII","YLR349W","+",828671,828806,828624,182,"W-close-W",828624,828806,"chrXII"
"chrXII","YLR350W (ORM2)","+",829485,829527,829314,213,"W-close-F",829314,829527,"chrXII"
"chrXII","YLR351C (NIT3)","-",829362,829314,829527,213,"F-close-W",829314,829527,"chrXII"
"chrXII","YLR352W","+",833636,833631,833460,171,"W-close-W",833460,833631,"chrXII"
"chrXII","YLR353W (BUD8)","+",836315,836373,836280,93,"F-overlap-F",836280,836373,"chrXII"
"chrXII","YLR354C (TAL1)","-",836198,836046,836280,234,"F-open-F",836046,836280,"chrXII"
"chrXII","YLR355C (ILV5)","-",837848,837858,837971,113,"F-overlap-F",837858,837971,"chrXII"
"chrXII","YLR356W (ATG33)","+",841052,841070,840914,156,"W-close-W",840914,841070,"chrXII"
"chrXII","YLR357W (RSC2)","+",844191,844193,843932,261,"W-open-W",843932,844193,"chrXII"
"chrXII","YLR359W (ADE13 BRA1 BRA8)","+",845858,846060,845830,230,"F-open-W",845830,846060,"chrXII"
"chrXII","YLR360W (VPS38 VPL17)","+",847561,847616,847514,102,"F-overlap-F",847514,847616,"chrXII"
"chrXII","YLR361C (DCR2)","-",846991,846880,847048,168,"W-close-W",846880,847048,"chrXII"
"chrXII","YLR361C-A","-",849239,849112,849311,199,"W-close-W",849112,849311,"chrXII"
"chrXII","YLR362W (STE11)","+",852132,852193,852012,181,"F-close-W",852012,852193,"chrXII"
"chrXII","YLR363C (NMD4)","-",852059,852012,852193,181,"W-close-F",852012,852193,"chrXII"
"chrXII","YLR363W-A","+",853884,854000,853775,225,"W-open-W",853775,854000,"chrXII"
"chrXII","YLR364W (GRX8)","+",854459,854558,854339,219,"W-open-F",854339,854558,"chrXII"
"chrXII","YLR367W (RPS22B)","+",857371,857547,857314,233,"F-open-W",857314,857547,"chrXII"
"chrXII","YLR368W (MDM30 DSG1)","+",859371,859355,859269,86,"W-overlap-F",859269,859355,"chrXII"
"chrXII","YLR369W (SSQ1 SSC2 SSH1)","+",861648,861772,861595,177,"F-close-W",861595,861772,"chrXII"
"chrXII","YLR370C (ARC18)","-",861550,861466,861595,129,"F-close-F",861466,861595,"chrXII"
"chrXII","YLR371W (ROM2)","+",866956,867171,866830,341,"W-open-W",866830,867171,"chrXII"
"chrXII","YLR372W (SUR4 APA1 ELO3 SRE1 VBM1)","+",868517,868509,868343,166,"W-close-W",868343,868509,"chrXII"
"chrXII","YLR373C (VID22)","-",868573,868509,868600,91,"F-overlap-W",868509,868600,"chrXII"
"chrXII","YLR375W (STP3)","+",872820,872882,872690,192,"W-close-W",872690,872882,"chrXII"
"chrXII","YLR376C (PSY3)","-",872738,872690,872882,192,"W-close-W",872690,872882,"chrXII"
"chrXII","YLR378C (SEC61)","-",875580,NA,NA,NA,"+1_missing",875082,875626,"chrXII"
"chrXII","YLR380W (CSR1 SFH2)","+",879618,879741,879475,266,"W-open-W",879475,879741,"chrXII"
"chrXII","YLR381W (CTF3 CHL3)","+",881941,882057,881791,266,"F-open-F",881791,882057,"chrXII"
"chrXII","YLR382C (NAM2 MSL1)","-",881992,881791,882057,266,"F-open-F",881791,882057,"chrXII"
"chrXII","YLR383W (SMC6 RHC18)","+",888694,888851,888563,288,"W-open-W",888563,888851,"chrXII"
"chrXII","YLR384C (IKI3 ELP1 KTI7 TOT1)","-",888757,888563,888851,288,"W-open-W",888563,888851,"chrXII"
"chrXII","YLR386W (VAC14)","+",896388,896389,896216,173,"F-close-F",896216,896389,"chrXII"
"chrXII","YLR387C (REH1)","-",896280,896216,896389,173,"F-close-F",896216,896389,"chrXII"
"chrXII","YLR388W (RPS29A YS29A)","+",898914,898939,898746,193,"W-close-W",898746,898939,"chrXII"
"chrXII","YLR389C (STE23)","-",899478,899373,899509,136,"F-close-W",899373,899509,"chrXII"
"chrXII","YLR390W (ECM19)","+",903480,903721,903351,370,"W-open-W",903351,903721,"chrXII"
"chrXII","YLR390W-A (CCW14 ICWP SSR1 YLR391W YLR391W-A)","+",904635,904718,904542,176,"F-close-F",904542,904718,"chrXII"
"chrXII","YLR392C (ART10)","-",904657,904542,904718,176,"F-close-F",904542,904718,"chrXII"
"chrXII","YLR395C (COX8)","-",909458,909473,909677,204,"W-close-W",909473,909677,"chrXII"
"chrXII","YLR396C (VPS33 CLS14 MET27 PEP14 SLP1 VAM5 VPL25 VPT33)","-",910179,909996,910312,316,"W-open-W",909996,910312,"chrXII"
"chrXII","YLR397C (AFG2 DRG1)","-",912414,912305,912584,279,"W-open-W",912305,912584,"chrXII"
"chrXII","YLR398C (SKI2)","-",915045,914871,915141,270,"W-open-W",914871,915141,"chrXII"
"chrXII","YLR399C (BDF1)","-",919220,919033,919294,261,"F-open-W",919033,919294,"chrXII"
"chrXII","YLR400W","+",922558,922663,922508,155,"W-close-W",922508,922663,"chrXII"
"chrXII","YLR401C (DUS3)","-",922397,922243,922508,265,"W-open-F",922243,922508,"chrXII"
"chrXII","YLR403W (SFP1)","+",927688,927725,927651,74,"F-overlap-W",927651,927725,"chrXII"
"chrXII","YLR404W (FLD1 SEI1)","+",929712,929841,929557,284,"W-open-W",929557,929841,"chrXII"
"chrXII","YLR405W (DUS4)","+",931040,931170,930971,199,"F-close-W",930971,931170,"chrXII"
"chrXII","YLR406C (RPL31B)","-",930884,930822,930971,149,"F-close-W",930822,930971,"chrXII"
"chrXII","YLR407W","+",933869,933925,933652,273,"W-open-F",933652,933925,"chrXII"
"chrXII","YLR408C (BLS1 BLB1)","-",933772,933652,933925,273,"F-open-W",933652,933925,"chrXII"
"chrXII","YLR409C (UTP21)","-",934363,934193,934475,282,"W-open-W",934193,934475,"chrXII"
"chrXII","YLR410W (VIP1)","+",941065,941241,940940,301,"W-open-W",940940,941241,"chrXII"
"chrXII","YLR411W (CTR3)","+",948147,948395,948122,273,"W-open-W",948122,948395,"chrXII"
"chrXII","YLR412C-A","-",949136,949072,949210,138,"W-close-W",949072,949210,"chrXII"
"chrXII","YLR412W (BER1)","+",949429,949562,949393,169,"W-close-W",949393,949562,"chrXII"
"chrXII","YLR413W","+",953319,953470,953278,192,"F-close-F",953278,953470,"chrXII"
"chrXII","YLR414C (PUN1)","-",953239,953115,953278,163,"F-close-F",953115,953278,"chrXII"
"chrXII","YLR415C","-",953528,953470,953573,103,"F-overlap-F",953470,953573,"chrXII"
"chrXII","YLR417W (VPS36 GRD12 VAC3 VPL11)","+",956809,956829,956725,104,"F-overlap-F",956725,956829,"chrXII"
"chrXII","YLR418C (CDC73)","-",956673,956592,956725,133,"F-close-F",956592,956725,"chrXII"
"chrXII","YLR419W","+",962813,962830,962646,184,"W-close-W",962646,962830,"chrXII"
"chrXII","YLR420W (URA4)","+",964960,965050,964859,191,"F-close-W",964859,965050,"chrXII"
"chrXII","YLR421C (RPN13)","-",964859,964859,965050,191,"W-close-F",964859,965050,"chrXII"
"chrXII","YLR422W","+",971793,971891,971771,120,"F-close-F",971771,971891,"chrXII"
"chrXII","YLR423C (ATG17 APG17)","-",971688,971604,971771,167,"F-close-F",971604,971771,"chrXII"
"chrXII","YLR424W (SPP382 CCF8 NTR1)","+",975628,975694,975478,216,"W-open-W",975478,975694,"chrXII"
"chrXII","YLR425W (TUS1 SOP10)","+",986896,987099,986843,256,"W-open-W",986843,987099,"chrXII"
"chrXII","YLR426W","+",988191,988393,988134,259,"W-open-W",988134,988393,"chrXII"
"chrXII","YLR427W (MAG2)","+",990603,990805,990514,291,"W-open-W",990514,990805,"chrXII"
"chrXII","YLR428C","-",990487,990369,990514,145,"W-close-W",990369,990514,"chrXII"
"chrXII","YLR429W (CRN1)","+",992868,992920,992723,197,"W-close-W",992723,992920,"chrXII"
"chrXII","YLR430W (SEN1 CIK3 NRD2)","+",1000224,1000288,1000081,207,"W-close-W",1000081,1000288,"chrXII"
"chrXII","YLR431C (ATG23 CVT23)","-",1000134,1000081,1000288,207,"W-close-W",1000081,1000288,"chrXII"
"chrXII","YLR432W (IMD3)","+",1004236,1004285,1004187,98,"F-overlap-F",1004187,1004285,"chrXII"
"chrXII","YLR433C (CNA1 CMP1)","-",1004084,1004069,1004187,118,"F-overlap-F",1004069,1004187,"chrXII"
"chrXII","YLR435W (TSR2)","+",1007158,1007208,1007135,73,"F-overlap-F",1007135,1007208,"chrXII"
"chrXII","YLR436C (ECM30)","-",1007299,1007208,1007417,209,"F-close-F",1007208,1007417,"chrXII"
"chrXII","YLR437C (DIF1)","-",1011468,1011251,1011547,296,"F-open-W",1011251,1011547,"chrXII"
"chrXII","YLR438C-A (LSM3 SMX4 USS2)","-",1013805,1013715,1013925,210,"F-close-W",1013715,1013925,"chrXII"
"chrXII","YLR438W (CAR2 cargB)","+",1013878,1013925,1013715,210,"W-close-F",1013715,1013925,"chrXII"
"chrXII","YLR439W (MRPL4)","+",1015589,1015656,1015453,203,"F-close-W",1015453,1015656,"chrXII"
"chrXII","YLR440C (SEC39 DSL3)","-",1015445,1015453,1015656,203,"W-close-F",1015453,1015656,"chrXII"
"chrXII","YLR441C (RPS1A RP10A)","-",1017924,1017933,1018113,180,"F-close-W",1017933,1018113,"chrXII"
"chrXII","YLR442C (SIR3 CMT1 MAR2 STE8)","-",1019216,NA,NA,NA,"+1_missing",1018913,1019318,"chrXII"
"chrXII","YLR443W (ECM7 ZRG15)","+",1024072,1024238,1024010,228,"W-open-W",1024010,1024238,"chrXII"
"chrXII","YLR445W","+",1024885,1024916,1024743,173,"W-close-W",1024743,1024916,"chrXII"
"chrXII","YLR446W","+",1026791,1026932,1026613,319,"W-open-W",1026613,1026932,"chrXII"
"chrXII","YLR447C (VMA6)","-",1026704,1026613,1026932,319,"W-open-W",1026613,1026932,"chrXII"
"chrXII","YLR448W (RPL6B)","+",1030022,1030072,1029868,204,"W-close-W",1029868,1030072,"chrXII"
"chrXII","YLR449W (FPR4)","+",1032098,1032219,1032041,178,"W-close-W",1032041,1032219,"chrXII"
"chrXII","YLR450W (HMG2)","+",1035847,1036058,1035769,289,"W-open-W",1035769,1036058,"chrXII"
"chrXII","YLR451W (LEU3)","+",1038944,1039018,1038855,163,"F-close-F",1038855,1039018,"chrXII"
"chrXII","YLR452C (SST2)","-",1038937,1038855,1039018,163,"F-close-F",1038855,1039018,"chrXII"
"chrXII","YLR453C (RIF2)","-",1041478,1041355,1041522,167,"W-close-W",1041355,1041522,"chrXII"
"chrXII","YLR454W (FMP27)","+",1051960,1051946,1051769,177,"W-close-W",1051769,1051946,"chrXII"
"chrXII","YLR455W","+",1054940,1055095,1054831,264,"W-open-W",1054831,1055095,"chrXII"
"chrXII","YLR456W","+",1055759,1055803,1055626,177,"W-close-F",1055626,1055803,"chrXII"
"chrXII","YLR457C (NBP1)","-",1055634,1055626,1055803,177,"F-close-W",1055626,1055803,"chrXII"
"chrXII","YLR459W (GAB1 CDC91)","+",1058590,1058736,1058561,175,"F-close-W",1058561,1058736,"chrXII"
"chrXII","YLR460C","-",1059594,1059538,1059645,107,"F-overlap-F",1059538,1059645,"chrXII"
"chrXIII","YML001W (YPT7 AST4 VAM4)","+",267909,267915,267742,173,"W-close-W",267742,267915,"chrXIII"
"chrXIII","YML002W","+",266842,266839,266665,174,"W-close-W",266665,266839,"chrXIII"
"chrXIII","YML004C (GLO1)","-",261569,261513,261758,245,"F-open-F",261513,261758,"chrXIII"
"chrXIII","YML005W (TRM12 TYW2)","+",261667,261758,261513,245,"F-open-F",261513,261758,"chrXIII"
"chrXIII","YML006C (GIS4)","-",256018,255941,256159,218,"W-open-F",255941,256159,"chrXIII"
"chrXIII","YML007C-A","-",252999,253016,253091,75,"F-overlap-F",253016,253091,"chrXIII"
"chrXIII","YML007W (YAP1 PAR1 SNQ3)","+",256019,256159,255941,218,"F-open-W",255941,256159,"chrXIII"
"chrXIII","YML008C (ERG6 ISE1 LIS1 SED6 VID1)","-",251745,251492,251808,316,"W-open-W",251492,251808,"chrXIII"
"chrXIII","YML009C (MRPL39)","-",251099,250951,251143,192,"F-close-F",250951,251143,"chrXIII"
"chrXIII","YML010W (SPT5)","+",251003,251143,250951,192,"F-close-F",250951,251143,"chrXIII"
"chrXIII","YML011C (RAD33)","-",246775,246748,246928,180,"W-close-W",246748,246928,"chrXIII"
"chrXIII","YML012W (ERV25)","+",246883,246928,246748,180,"W-close-W",246748,246928,"chrXIII"
"chrXIII","YML013W (UBX2 SEL1)","+",246106,246111,NA,NA,"-1_missing",245802,246111,"chrXIII"
"chrXIII","YML014W (TRM9 KTI1)","+",244140,244173,243888,285,"W-open-W",243888,244173,"chrXIII"
"chrXIII","YML015C (TAF11 TAF40)","-",241868,241776,242040,264,"W-open-W",241776,242040,"chrXIII"
"chrXIII","YML016C (PPZ1)","-",239316,239255,239539,284,"F-open-F",239255,239539,"chrXIII"
"chrXIII","YML017W (PSP2 MRS15)","+",239059,239082,238863,219,"W-open-F",238863,239082,"chrXIII"
"chrXIII","YML018C","-",234654,234655,234889,234,"F-open-F",234655,234889,"chrXIII"
"chrXIII","YML019W (OST6)","+",234716,234889,234655,234,"F-open-F",234655,234889,"chrXIII"
"chrXIII","YML020W","+",233315,233483,233217,266,"W-open-W",233217,233483,"chrXIII"
"chrXIII","YML021C (UNG1)","-",229573,229587,229753,166,"W-close-F",229587,229753,"chrXIII"
"chrXIII","YML022W (APT1)","+",229702,229753,229587,166,"F-close-W",229587,229753,"chrXIII"
"chrXIII","YML023C (NSE5)","-",226945,226887,227056,169,"W-close-W",226887,227056,"chrXIII"
"chrXIII","YML024W (RPS17A RP51A RPL51A)","+",226791,226887,226644,243,"F-open-W",226644,226887,"chrXIII"
"chrXIII","YML025C (YML6)","-",224300,NA,NA,NA,"+1_missing",223845,224376,"chrXIII"
"chrXIII","YML026C (RPS18B)","-",222796,222754,223051,297,"W-open-W",222754,223051,"chrXIII"
"chrXIII","YML027W (YOX1)","+",222721,222754,222532,222,"W-open-W",222532,222754,"chrXIII"
"chrXIII","YML028W (TSA1 TPX1 ZRG14)","+",220834,220872,220670,202,"W-close-W",220670,220872,"chrXIII"
"chrXIII","YML029W (USA1)","+",219970,220118,219826,292,"W-open-W",219826,220118,"chrXIII"
"chrXIII","YML030W (AIM31)","+",217137,217327,217100,227,"F-open-W",217100,217327,"chrXIII"
"chrXIII","YML031W (NDC1)","+",216232,216439,216139,300,"W-open-W",216139,216439,"chrXIII"
"chrXIII","YML032C (RAD52)","-",212223,212206,212276,70,"F-overlap-F",212206,212276,"chrXIII"
"chrXIII","YML034W (SRC1 HEH1 YML033W)","+",212323,212409,212276,133,"F-close-F",212276,212409,"chrXIII"
"chrXIII","YML035C (AMD1 AMD3)","-",206215,206161,206328,167,"F-close-F",206161,206328,"chrXIII"
"chrXIII","YML036W (CGI121)","+",206345,206328,206161,167,"F-close-F",206161,206328,"chrXIII"
"chrXIII","YML038C (YMD8)","-",202560,202432,202660,228,"F-open-F",202432,202660,"chrXIII"
"chrXIII","YML041C (VPS71 SWC6)","-",194828,194721,194955,234,"F-open-F",194721,194955,"chrXIII"
"chrXIII","YML042W (CAT2 YCAT)","+",194926,194955,194721,234,"F-open-F",194721,194955,"chrXIII"
"chrXIII","YML043C (RRN11)","-",190100,NA,NA,NA,"+1_missing",184106,190243,"chrXIII"
"chrXIII","YML046W (PRP39)","+",183459,183692,183303,389,"F-open-W",183303,183692,"chrXIII"
"chrXIII","YML048W (GSF2 ECM6)","+",179835,179933,179549,384,"W-open-F",179549,179933,"chrXIII"
"chrXIII","YML050W (AIM32)","+",174194,174254,174174,80,"F-overlap-W",174174,174254,"chrXIII"
"chrXIII","YML051W (GAL80)","+",173019,173002,172808,194,"W-close-F",172808,173002,"chrXIII"
"chrXIII","YML052W (SUR7)","+",171415,171570,171291,279,"W-open-W",171291,171570,"chrXIII"
"chrXIII","YML053C","-",169010,169017,169226,209,"F-close-F",169017,169226,"chrXIII"
"chrXIII","YML054C (CYB2)","-",165445,165315,165577,262,"W-open-W",165315,165577,"chrXIII"
"chrXIII","YML055W (SPC2 SPY1)","+",165381,165577,165315,262,"W-open-W",165315,165577,"chrXIII"
"chrXIII","YML056C (IMD4)","-",162106,162125,162259,134,"F-close-F",162125,162259,"chrXIII"
"chrXIII","YML057W (CMP2 CNA2)","+",162102,162125,162047,78,"F-overlap-F",162047,162125,"chrXIII"
"chrXIII","YML058W (SML1)","+",159955,160146,159875,271,"F-open-W",159875,160146,"chrXIII"
"chrXIII","YML058W-A (HUG1)","+",159098,159390,158942,448,"W-open-W",158942,159390,"chrXIII"
"chrXIII","YML059C (NTE1)","-",153090,153064,153142,78,"F-overlap-F",153064,153142,"chrXIII"
"chrXIII","YML060W (OGG1)","+",153168,153250,153142,108,"F-overlap-F",153142,153250,"chrXIII"
"chrXIII","YML061C (PIF1 TST1)","-",148883,148902,149077,175,"W-close-F",148902,149077,"chrXIII"
"chrXIII","YML062C (MFT1 MFT52)","-",147425,147146,147523,377,"W-open-W",147146,147523,"chrXIII"
"chrXIII","YML063W (RPS1B PLC2 RP10B)","+",147314,147523,147146,377,"W-open-W",147146,147523,"chrXIII"
"chrXIII","YML064C (TEM1)","-",144942,144879,145070,191,"W-close-W",144879,145070,"chrXIII"
"chrXIII","YML065W (ORC1)","+",145045,145070,144879,191,"W-close-W",144879,145070,"chrXIII"
"chrXIII","YML067C (ERV41)","-",139012,138969,139088,119,"F-overlap-W",138969,139088,"chrXIII"
"chrXIII","YML068W (ITT1)","+",139041,139088,138969,119,"W-overlap-F",138969,139088,"chrXIII"
"chrXIII","YML069W (POB3)","+",137230,137237,137069,168,"W-close-F",137069,137237,"chrXIII"
"chrXIII","YML070W (DAK1)","+",135299,135492,135177,315,"W-open-W",135177,135492,"chrXIII"
"chrXIII","YML071C (COG8 DOR1)","-",129705,129542,129826,284,"W-open-W",129542,129826,"chrXIII"
"chrXIII","YML072C (TCB3)","-",124589,124387,124702,315,"W-open-F",124387,124702,"chrXIII"
"chrXIII","YML073C (RPL6A YL16A)","-",123150,123125,123206,81,"F-overlap-F",123125,123206,"chrXIII"
"chrXIII","YML074C (FPR3 NPI46)","-",119988,119825,120032,207,"F-close-W",119825,120032,"chrXIII"
"chrXIII","YML075C (HMG1)","-",115625,115589,115661,72,"F-overlap-W",115589,115661,"chrXIII"
"chrXIII","YML076C (WAR1)","-",112356,112220,112399,179,"F-close-W",112220,112399,"chrXIII"
"chrXIII","YML077W (BET5)","+",112470,112612,112399,213,"F-close-F",112399,112612,"chrXIII"
"chrXIII","YML078W (CPR3 CYP3)","+",111706,111883,111674,209,"W-close-W",111674,111883,"chrXIII"
"chrXIII","YML079W","+",110930,111040,110790,250,"W-open-W",110790,111040,"chrXIII"
"chrXIII","YML080W (DUS1)","+",110185,110272,110060,212,"W-close-W",110060,110272,"chrXIII"
"chrXIII","YML081C-A (ATP18)","-",103838,103794,104003,209,"W-close-F",103794,104003,"chrXIII"
"chrXIII","YML081W","+",108588,108754,108490,264,"W-open-W",108490,108754,"chrXIII"
"chrXIII","YML082W","+",103959,104003,103794,209,"F-close-W",103794,104003,"chrXIII"
"chrXIII","YML085C (TUB1)","-",97781,97730,97920,190,"W-close-W",97730,97920,"chrXIII"
"chrXIII","YML086C (ALO1)","-",95675,95444,95893,449,"W-open-F",95444,95893,"chrXIII"
"chrXIII","YML087C (AIM33)","-",94322,94190,94481,291,"W-open-W",94190,94481,"chrXIII"
"chrXIII","YML088W (UFO1)","+",94352,94481,94190,291,"W-open-W",94190,94481,"chrXIII"
"chrXIII","YML089C","-",90834,90705,90917,212,"F-close-W",90705,90917,"chrXIII"
"chrXIII","YML091C (RPM2)","-",87035,NA,NA,NA,"+1_missing",86715,87200,"chrXIII"
"chrXIII","YML092C (PRE8)","-",85874,85717,86076,359,"W-open-F",85717,86076,"chrXIII"
"chrXIII","YML093W (UTP14)","+",85920,86076,85717,359,"F-open-W",85717,86076,"chrXIII"
"chrXIII","YML094W (GIM5 PFD5)","+",82960,83129,82823,306,"W-open-W",82823,83129,"chrXIII"
"chrXIII","YML095C (RAD10)","-",80813,80778,80961,183,"F-close-W",80778,80961,"chrXIII"
"chrXIII","YML096W","+",81613,81763,81582,181,"W-close-W",81582,81763,"chrXIII"
"chrXIII","YML097C (VPS9 VPL31 VPT9)","-",78250,NA,NA,NA,"+1_missing",77769,78270,"chrXIII"
"chrXIII","YML098W (TAF13 FUN81 TAF19)","+",77929,NA,NA,NA,"+1_missing",77769,78270,"chrXIII"
"chrXIII","YML099C (ARG81 ARGR2 ARGRII)","-",74244,74231,74453,222,"W-open-F",74231,74453,"chrXIII"
"chrXIII","YML100W (TSL1)","+",74035,74070,73846,224,"F-open-W",73846,74070,"chrXIII"
"chrXIII","YML101C (CUE4)","-",69679,69554,69719,165,"W-close-W",69554,69719,"chrXIII"
"chrXIII","YML102W (CAC2)","+",69753,NA,NA,NA,"+1_missing",69719,70070,"chrXIII"
"chrXIII","YML103C (NUP188)","-",62527,62545,62703,158,"W-close-W",62545,62703,"chrXIII"
"chrXIII","YML104C (MDM1)","-",58879,58653,58921,268,"W-open-W",58653,58921,"chrXIII"
"chrXIII","YML105C (SEC65)","-",57761,57660,57806,146,"F-close-W",57660,57806,"chrXIII"
"chrXIII","YML106W (URA5 PYR5)","+",57604,57660,57582,78,"F-overlap-W",57582,57660,"chrXIII"
"chrXIII","YML107C (PML39)","-",55227,55145,55440,295,"W-open-W",55145,55440,"chrXIII"
"chrXIII","YML108W","+",55316,55440,55145,295,"W-open-W",55145,55440,"chrXIII"
"chrXIII","YML109W (ZDS2 CES4)","+",54548,54779,54523,256,"W-open-W",54523,54779,"chrXIII"
"chrXIII","YML110C (COQ5 DBI56)","-",49851,49708,49949,241,"W-open-F",49708,49949,"chrXIII"
"chrXIII","YML111W (BUL2)","+",49828,49949,49708,241,"F-open-W",49708,49949,"chrXIII"
"chrXIII","YML112W (CTK3)","+",46039,46184,45911,273,"F-open-W",45911,46184,"chrXIII"
"chrXIII","YML113W (DAT1)","+",44935,45073,44850,223,"W-open-W",44850,45073,"chrXIII"
"chrXIII","YML114C (TAF8 TAF65)","-",41991,41793,42080,287,"W-open-W",41793,42080,"chrXIII"
"chrXIII","YML115C (VAN1 LDB13 VRG7 VRG8)","-",40000,39955,40036,81,"F-overlap-F",39955,40036,"chrXIII"
"chrXIII","YML116W (ATR1 SNQ1)","+",39977,40036,39955,81,"F-overlap-F",39955,40036,"chrXIII"
"chrXIII","YML117W (NAB6)","+",38014,38102,37933,169,"F-close-W",37933,38102,"chrXIII"
"chrXIII","YML118W (NGL3)","+",33888,34143,33863,280,"W-open-W",33863,34143,"chrXIII"
"chrXIII","YML119W","+",31744,31911,31679,232,"F-open-W",31679,31911,"chrXIII"
"chrXIII","YML120C (NDI1)","-",27907,27883,28024,141,"W-close-W",27883,28024,"chrXIII"
"chrXIII","YML121W (GTR1)","+",28044,28183,28024,159,"W-close-W",28024,28183,"chrXIII"
"chrXIII","YML122C","-",25855,25792,25959,167,"W-close-W",25792,25959,"chrXIII"
"chrXIII","YML123C (PHO84 phoT)","-",23899,23659,23966,307,"F-open-W",23659,23966,"chrXIII"
"chrXIII","YML124C (TUB3)","-",21909,21682,21972,290,"F-open-W",21682,21972,"chrXIII"
"chrXIII","YML125C (PGA3 NQR1)","-",20679,20638,20711,73,"F-overlap-F",20638,20711,"chrXIII"
"chrXIII","YML127W (RSC9)","+",18975,18994,18762,232,"F-open-F",18762,18994,"chrXIII"
"chrXIII","YML128C (MSC1)","-",14948,14721,14976,255,"F-open-W",14721,14976,"chrXIII"
"chrXIII","YML129C (COX14)","-",14327,14305,14391,86,"W-overlap-F",14305,14391,"chrXIII"
"chrXIII","YML130C (ERO1)","-",11394,11322,11420,98,"F-overlap-F",11322,11420,"chrXIII"
"chrXIII","YML131W","+",11488,11549,11420,129,"F-close-F",11420,11549,"chrXIII"
"chrXIII","YML132W (COS3)","+",8459,8465,NA,NA,"-1_missing",8459,8465,"chrXIII"
"chrXIII","YMR001C (CDC5 MSD2 PKX2)","-",268860,268824,269024,200,"F-close-W",268824,269024,"chrXIII"
"chrXIII","YMR002W (MIC17)","+",272902,273117,272792,325,"F-open-W",272792,273117,"chrXIII"
"chrXIII","YMR003W (AIM34)","+",273794,273991,273715,276,"W-open-W",273715,273991,"chrXIII"
"chrXIII","YMR004W (MVP1)","+",275700,275723,275524,199,"W-close-F",275524,275723,"chrXIII"
"chrXIII","YMR005W (TAF4 MPT1 TAF48 TSG2)","+",277309,277312,277136,176,"W-close-F",277136,277312,"chrXIII"
"chrXIII","YMR006C (PLB2)","-",277460,277471,277637,166,"F-close-F",277471,277637,"chrXIII"
"chrXIII","YMR007W","+",280496,280556,280475,81,"F-overlap-F",280475,280556,"chrXIII"
"chrXIII","YMR008C (PLB1)","-",280347,280306,280387,81,"F-overlap-W",280306,280387,"chrXIII"
"chrXIII","YMR009W (ADI1)","+",284746,284901,284575,326,"W-open-W",284575,284901,"chrXIII"
"chrXIII","YMR010W","+",286479,286599,286418,181,"F-close-F",286418,286599,"chrXIII"
"chrXIII","YMR011W (HXT2)","+",289819,289857,289699,158,"F-close-F",289699,289857,"chrXIII"
"chrXIII","YMR012W (CLU1 TIF31)","+",295103,295297,294971,326,"F-open-W",294971,295297,"chrXIII"
"chrXIII","YMR013C (SEC59)","-",295092,294971,295297,326,"W-open-F",294971,295297,"chrXIII"
"chrXIII","YMR013W-A","+",298561,298593,298398,195,"W-close-W",298398,298593,"chrXIII"
"chrXIII","YMR014W (BUD22)","+",300538,300597,300461,136,"F-close-F",300461,300597,"chrXIII"
"chrXIII","YMR015C (ERG5 CYP61)","-",300679,300597,300715,118,"F-overlap-F",300597,300715,"chrXIII"
"chrXIII","YMR016C (SOK2)","-",303101,NA,NA,NA,"+1_missing",302757,303185,"chrXIII"
"chrXIII","YMR017W (SPO20 DBI9)","+",308770,308805,308610,195,"W-close-W",308610,308805,"chrXIII"
"chrXIII","YMR018W","+",311817,311835,311664,171,"W-close-W",311664,311835,"chrXIII"
"chrXIII","YMR019W (STB4)","+",315109,315201,315056,145,"W-close-F",315056,315201,"chrXIII"
"chrXIII","YMR020W (FMS1)","+",316994,317079,316884,195,"F-close-F",316884,317079,"chrXIII"
"chrXIII","YMR021C (MAC1 CUA1)","-",316894,316884,317079,195,"F-close-F",316884,317079,"chrXIII"
"chrXIII","YMR022W (UBC7 QRI8)","+",319324,319354,319192,162,"W-close-W",319192,319354,"chrXIII"
"chrXIII","YMR023C (MSS1 PET53)","-",319381,319354,319527,173,"W-close-W",319354,319527,"chrXIII"
"chrXIII","YMR024W (MRPL3)","+",323195,323313,323093,220,"W-open-W",323093,323313,"chrXIII"
"chrXIII","YMR025W (CSI1)","+",324228,324218,324046,172,"W-close-F",324046,324218,"chrXIII"
"chrXIII","YMR026C (PEX12 PAS11)","-",324147,324046,324218,172,"F-close-W",324046,324218,"chrXIII"
"chrXIII","YMR027W","+",327354,327511,327267,244,"W-open-W",327267,327511,"chrXIII"
"chrXIII","YMR028W (TAP42)","+",328678,328728,328508,220,"W-open-F",328508,328728,"chrXIII"
"chrXIII","YMR029C (FAR8)","-",328565,328508,328728,220,"F-open-W",328508,328728,"chrXIII"
"chrXIII","YMR030W (RSF1)","+",332031,332156,331868,288,"W-open-F",331868,332156,"chrXIII"
"chrXIII","YMR031C","-",332028,331868,332156,288,"F-open-W",331868,332156,"chrXIII"
"chrXIII","YMR032W (HOF1 CYK2)","+",337581,337799,337520,279,"W-open-W",337520,337799,"chrXIII"
"chrXIII","YMR033W (ARP9 RSC12 SWP59)","+",339432,339492,339301,191,"W-close-F",339301,339492,"chrXIII"
"chrXIII","YMR034C","-",339311,339301,339492,191,"F-close-W",339301,339492,"chrXIII"
"chrXIII","YMR035W (IMP2)","+",341833,341852,341656,196,"W-close-F",341656,341852,"chrXIII"
"chrXIII","YMR036C (MIH1)","-",341718,341656,341852,196,"F-close-W",341656,341852,"chrXIII"
"chrXIII","YMR037C (MSN2)","-",344138,344118,344326,208,"W-close-F",344118,344326,"chrXIII"
"chrXIII","YMR038C (CCS1 CCS LYS7)","-",347390,347242,347470,228,"F-open-F",347242,347470,"chrXIII"
"chrXIII","YMR039C (SUB1 TSP1)","-",348467,348234,348687,453,"F-open-W",348234,348687,"chrXIII"
"chrXIII","YMR040W (YET2)","+",350941,351057,350826,231,"F-open-F",350826,351057,"chrXIII"
"chrXIII","YMR041C (ARA2)","-",350845,350826,351057,231,"F-open-F",350826,351057,"chrXIII"
"chrXIII","YMR042W (ARG80 ARGR1 ARGRI)","+",353593,353887,353572,315,"F-open-W",353572,353887,"chrXIII"
"chrXIII","YMR043W (MCM1 FUN80)","+",355061,355076,354908,168,"W-close-F",354908,355076,"chrXIII"
"chrXIII","YMR044W (IOC4)","+",356995,356978,356781,197,"F-close-W",356781,356978,"chrXIII"
"chrXIII","YMR047C (NUP116 NSP116)","-",363284,363262,363441,179,"W-close-W",363262,363441,"chrXIII"
"chrXIII","YMR048W (CSM3)","+",368043,368088,367991,97,"F-overlap-F",367991,368088,"chrXIII"
"chrXIII","YMR049C (ERB1)","-",368034,367991,368088,97,"F-overlap-F",367991,368088,"chrXIII"
"chrXIII","YMR052W (FAR3)","+",380338,380422,380203,219,"F-open-W",380203,380422,"chrXIII"
"chrXIII","YMR053C (STB2)","-",379574,NA,NA,NA,"+1_missing",379123,379601,"chrXIII"
"chrXIII","YMR054W (STV1)","+",386093,386181,386034,147,"F-close-W",386034,386181,"chrXIII"
"chrXIII","YMR055C (BUB2 PAC7)","-",386022,386034,386181,147,"W-close-F",386034,386181,"chrXIII"
"chrXIII","YMR056C (AAC1)","-",387190,387000,387275,275,"W-open-W",387000,387275,"chrXIII"
"chrXIII","YMR057C","-",388039,387923,388101,178,"W-close-W",387923,388101,"chrXIII"
"chrXIII","YMR058W (FET3)","+",390877,390872,390703,169,"F-close-W",390703,390872,"chrXIII"
"chrXIII","YMR059W (SEN15)","+",391588,391640,391455,185,"W-close-F",391455,391640,"chrXIII"
"chrXIII","YMR060C (SAM37 MAS37 PET3027 TOM37)","-",391497,391455,391640,185,"F-close-W",391455,391640,"chrXIII"
"chrXIII","YMR061W (RNA14)","+",394892,394979,394818,161,"F-close-F",394818,394979,"chrXIII"
"chrXIII","YMR062C (ARG7 ECM40)","-",394971,394979,395184,205,"F-close-F",394979,395184,"chrXIII"
"chrXIII","YMR063W (RIM9)","+",397875,397982,397710,272,"W-open-W",397710,397982,"chrXIII"
"chrXIII","YMR064W (AEP1 NCA1)","+",399577,399646,399470,176,"W-close-W",399470,399646,"chrXIII"
"chrXIII","YMR066W (SOV1)","+",404303,404345,404183,162,"F-close-F",404183,404345,"chrXIII"
"chrXIII","YMR067C (UBX4 CUI1)","-",404285,404183,404345,162,"F-close-F",404183,404345,"chrXIII"
"chrXIII","YMR068W (AVO2)","+",407681,407826,407501,325,"W-open-W",407501,407826,"chrXIII"
"chrXIII","YMR070W (MOT3 ROX7)","+",410695,410793,410612,181,"W-close-F",410612,410793,"chrXIII"
"chrXIII","YMR071C (TVP18)","-",410693,410612,410793,181,"F-close-W",410612,410793,"chrXIII"
"chrXIII","YMR072W (ABF2)","+",412258,412386,412230,156,"F-close-W",412230,412386,"chrXIII"
"chrXIII","YMR073C (IRC21)","-",412149,412087,412230,143,"F-close-W",412087,412230,"chrXIII"
"chrXIII","YMR074C","-",412959,412857,413120,263,"W-open-W",412857,413120,"chrXIII"
"chrXIII","YMR075W (RCO1)","+",416150,416237,416113,124,"F-close-F",416113,416237,"chrXIII"
"chrXIII","YMR076C (PDS5)","-",416063,415883,416113,230,"F-open-W",415883,416113,"chrXIII"
"chrXIII","YMR077C (VPS20 CHM6 VPL10 VPT20)","-",421327,421180,421359,179,"F-close-W",421180,421359,"chrXIII"
"chrXIII","YMR078C (CTF18 CHL12)","-",422384,422151,422406,255,"W-open-W",422151,422406,"chrXIII"
"chrXIII","YMR079W (SEC14 PIT1)","+",426389,426478,426345,133,"W-close-F",426345,426478,"chrXIII"
"chrXIII","YMR080C (NAM7 IFS2 MOF4 SUP113 UPF1)","-",426290,426143,426345,202,"W-close-F",426143,426345,"chrXIII"
"chrXIII","YMR081C (ISF1 MBR3)","-",429891,429671,429987,316,"W-open-W",429671,429987,"chrXIII"
"chrXIII","YMR083W (ADH3)","+",436009,436112,435915,197,"W-close-W",435915,436112,"chrXIII"
"chrXIII","YMR086C-A","-",440616,440621,440785,164,"F-close-W",440621,440785,"chrXIII"
"chrXIII","YMR086W","+",442228,442251,442084,167,"W-close-W",442084,442251,"chrXIII"
"chrXIII","YMR087W","+",443415,443526,443387,139,"F-close-W",443387,443526,"chrXIII"
"chrXIII","YMR088C (VBA1)","-",443300,443311,443387,76,"F-overlap-F",443311,443387,"chrXIII"
"chrXIII","YMR089C (YTA12 RCA1)","-",445408,445411,445608,197,"W-close-W",445411,445608,"chrXIII"
"chrXIII","YMR090W","+",450001,450057,449870,187,"W-close-F",449870,450057,"chrXIII"
"chrXIII","YMR091C (NPL6 RSC7)","-",449985,449870,450057,187,"F-close-W",449870,450057,"chrXIII"
"chrXIII","YMR092C (AIP1)","-",451552,451365,451655,290,"W-open-W",451365,451655,"chrXIII"
"chrXIII","YMR093W (UTP15)","+",455659,455854,455449,405,"W-open-W",455449,455854,"chrXIII"
"chrXIII","YMR094W (CTF13 CBF3C)","+",457882,457915,457763,152,"W-close-W",457763,457915,"chrXIII"
"chrXIII","YMR096W (SNZ1)","+",459476,459578,459387,191,"F-close-F",459387,459578,"chrXIII"
"chrXIII","YMR097C (MTG1)","-",459365,459203,459387,184,"F-close-F",459203,459387,"chrXIII"
"chrXIII","YMR098C (ATP25 LRC4)","-",460697,460517,460755,238,"F-open-W",460517,460755,"chrXIII"
"chrXIII","YMR099C","-",463845,463772,463954,182,"W-close-W",463772,463954,"chrXIII"
"chrXIII","YMR100W (MUB1)","+",468379,468436,468357,79,"F-overlap-F",468357,468436,"chrXIII"
"chrXIII","YMR101C (SRT1)","-",468273,468170,468357,187,"F-close-W",468170,468357,"chrXIII"
"chrXIII","YMR102C","-",469729,469671,469877,206,"W-close-W",469671,469877,"chrXIII"
"chrXIII","YMR103C","-",472731,472711,NA,NA,"-1_missing",472711,473271,"chrXIII"
"chrXIII","YMR104C (YPK2 YKR2)","-",473187,NA,NA,NA,"+1_missing",472711,473271,"chrXIII"
"chrXIII","YMR105C (PGM2 GAL5)","-",475747,475757,475934,177,"W-close-F",475757,475934,"chrXIII"
"chrXIII","YMR106C (YKU80 HDF2)","-",478174,478096,478214,118,"F-overlap-F",478096,478214,"chrXIII"
"chrXIII","YMR107W (SPG4)","+",483537,483527,483338,189,"W-close-F",483338,483527,"chrXIII"
"chrXIII","YMR108W (ILV2 SMR1 THI1)","+",486314,486313,486129,184,"W-close-W",486129,486313,"chrXIII"
"chrXIII","YMR109W (MYO5)","+",490328,490451,490277,174,"F-close-F",490277,490451,"chrXIII"
"chrXIII","YMR110C (HFD1)","-",490242,490189,490277,88,"F-overlap-F",490189,490277,"chrXIII"
"chrXIII","YMR111C","-",492235,492215,492409,194,"W-close-F",492215,492409,"chrXIII"
"chrXIII","YMR112C (MED11)","-",493976,493874,494073,199,"W-close-W",493874,494073,"chrXIII"
"chrXIII","YMR113W (FOL3)","+",496344,496439,496268,171,"F-close-F",496268,496439,"chrXIII"
"chrXIII","YMR114C","-",496252,496268,496439,171,"F-close-F",496268,496439,"chrXIII"
"chrXIII","YMR115W (MGR3 FMP24)","+",499334,499488,499244,244,"F-open-F",499244,499488,"chrXIII"
"chrXIII","YMR116C (ASC1 CPC2)","-",499315,499244,499488,244,"F-open-F",499244,499488,"chrXIII"
"chrXIII","YMR117C (SPC24)","-",501035,500784,501115,331,"W-open-W",500784,501115,"chrXIII"
"chrXIII","YMR118C","-",502044,501877,502179,302,"W-open-W",501877,502179,"chrXIII"
"chrXIII","YMR119W (ASI1)","+",507350,507578,507294,284,"F-open-F",507294,507578,"chrXIII"
"chrXIII","YMR120C (ADE17)","-",507339,507294,507578,284,"F-open-F",507294,507578,"chrXIII"
"chrXIII","YMR121C (RPL15B)","-",509673,509434,509723,289,"W-open-W",509434,509723,"chrXIII"
"chrXIII","YMR122C","-",510605,510322,510632,310,"W-open-W",510322,510632,"chrXIII"
"chrXIII","YMR122W-A","+",511819,511875,511720,155,"F-close-F",511720,511875,"chrXIII"
"chrXIII","YMR123W (PKR1)","+",514049,514222,513908,314,"W-open-W",513908,514222,"chrXIII"
"chrXIII","YMR124W","+",517365,517524,517230,294,"W-open-W",517230,517524,"chrXIII"
"chrXIII","YMR125W (STO1 CBC1 CBP80 GCR3 SUT1)","+",520607,520819,520432,387,"F-open-W",520432,520819,"chrXIII"
"chrXIII","YMR126C (DLT1)","-",520665,520432,520819,387,"W-open-F",520432,520819,"chrXIII"
"chrXIII","YMR127C (SAS2)","-",522121,521963,522223,260,"W-open-W",521963,522223,"chrXIII"
"chrXIII","YMR128W (ECM16 DHR1)","+",527576,527820,527516,304,"W-open-W",527516,527820,"chrXIII"
"chrXIII","YMR129W (POM152)","+",531923,531905,531716,189,"W-close-F",531716,531905,"chrXIII"
"chrXIII","YMR130W","+",533135,533148,533058,90,"F-overlap-F",533058,533148,"chrXIII"
"chrXIII","YMR131C (RRB1)","-",533071,533058,533148,90,"F-overlap-F",533058,533148,"chrXIII"
"chrXIII","YMR132C (JLP2)","-",534722,534716,534980,264,"W-open-W",534716,534980,"chrXIII"
"chrXIII","YMR134W","+",538727,538793,538664,129,"W-close-F",538664,538793,"chrXIII"
"chrXIII","YMR135C (GID8 DCR1)","-",538602,538476,538664,188,"W-close-W",538476,538664,"chrXIII"
"chrXIII","YMR136W (GAT2)","+",542953,543114,542835,279,"W-open-W",542835,543114,"chrXIII"
"chrXIII","YMR137C (PSO2 SNM1)","-",542875,542835,543114,279,"W-open-W",542835,543114,"chrXIII"
"chrXIII","YMR138W (CIN4 GTP1 UGX1)","+",545815,545944,545675,269,"W-open-W",545675,545944,"chrXIII"
"chrXIII","YMR139W (RIM11 GSK3 MDS1)","+",547358,547426,547229,197,"W-close-W",547229,547426,"chrXIII"
"chrXIII","YMR140W (SIP5)","+",550002,550070,549897,173,"W-close-W",549897,550070,"chrXIII"
"chrXIII","YMR142C (RPL13B)","-",550108,550070,550178,108,"F-overlap-W",550070,550178,"chrXIII"
"chrXIII","YMR143W (RPS16A)","+",553005,553276,552922,354,"W-open-W",552922,553276,"chrXIII"
"chrXIII","YMR144W","+",554559,554710,554483,227,"F-open-F",554483,554710,"chrXIII"
"chrXIII","YMR145C (NDE1 NDH1)","-",554594,554483,554710,227,"F-open-F",554483,554710,"chrXIII"
"chrXIII","YMR146C (TIF34)","-",557387,557252,557513,261,"W-open-W",557252,557513,"chrXIII"
"chrXIII","YMR147W","+",560532,560674,560442,232,"W-open-W",560442,560674,"chrXIII"
"chrXIII","YMR148W (OSW5)","+",560977,560978,NA,NA,"-1_missing",560674,560978,"chrXIII"
"chrXIII","YMR149W (SWP1)","+",561950,562005,561781,224,"W-open-W",561781,562005,"chrXIII"
"chrXIII","YMR150C (IMP1 PET-TS2858)","-",561853,561781,562005,224,"W-open-W",561781,562005,"chrXIII"
"chrXIII","YMR152W (YIM1)","+",564266,564437,564156,281,"W-open-W",564156,564437,"chrXIII"
"chrXIII","YMR153C-A","-",564206,564156,564437,281,"W-open-W",564156,564437,"chrXIII"
"chrXIII","YMR153W (NUP53)","+",566011,566029,565935,94,"W-overlap-F",565935,566029,"chrXIII"
"chrXIII","YMR154C (RIM13 CPL1)","-",565953,565935,566029,94,"F-overlap-W",565935,566029,"chrXIII"
"chrXIII","YMR155W","+",570335,570337,570133,204,"F-close-F",570133,570337,"chrXIII"
"chrXIII","YMR156C (TPP1)","-",570231,570133,570337,204,"F-close-F",570133,570337,"chrXIII"
"chrXIII","YMR157C (AIM36 FMP39)","-",571158,571160,571349,189,"W-close-W",571160,571349,"chrXIII"
"chrXIII","YMR158C-A (YMR158C-B)","-",573112,573097,573278,181,"W-close-W",573097,573278,"chrXIII"
"chrXIII","YMR158W (MRPS8)","+",572807,573097,572761,336,"W-open-W",572761,573097,"chrXIII"
"chrXIII","YMR160W","+",577559,577706,577440,266,"W-open-W",577440,577706,"chrXIII"
"chrXIII","YMR161W (HLJ1)","+",578773,578828,578730,98,"F-overlap-F",578730,578828,"chrXIII"
"chrXIII","YMR162C (DNF3)","-",578819,578828,578916,88,"F-overlap-F",578828,578916,"chrXIII"
"chrXIII","YMR163C (INP2)","-",584215,584050,584345,295,"W-open-F",584050,584345,"chrXIII"
"chrXIII","YMR164C (MSS11)","-",586894,586849,587055,206,"F-close-W",586849,587055,"chrXIII"
"chrXIII","YMR165C (PAH1 SMP2)","-",589934,589885,590069,184,"W-close-W",589885,590069,"chrXIII"
"chrXIII","YMR166C","-",593137,592993,593203,210,"W-close-W",592993,593203,"chrXIII"
"chrXIII","YMR167W (MLH1 PMS2)","+",597596,597627,597511,116,"F-overlap-F",597511,597627,"chrXIII"
"chrXIII","YMR168C (CEP3 CBF3 CBF3B CSL1)","-",596720,596674,596748,74,"F-overlap-F",596674,596748,"chrXIII"
"chrXIII","YMR169C (ALD3)","-",599297,599129,599410,281,"W-open-W",599129,599410,"chrXIII"
"chrXIII","YMR170C (ALD2)","-",601440,601320,601468,148,"F-close-W",601320,601468,"chrXIII"
"chrXIII","YMR171C (EAR1)","-",603615,603525,603675,150,"W-close-F",603525,603675,"chrXIII"
"chrXIII","YMR173W (DDR48 FSP)","+",610007,610188,609940,248,"W-open-F",609940,610188,"chrXIII"
"chrXIII","YMR173W-A","+",610133,610188,609940,248,"W-open-F",609940,610188,"chrXIII"
"chrXIII","YMR174C (PAI3)","-",609997,609940,610188,248,"F-open-W",609940,610188,"chrXIII"
"chrXIII","YMR175W (SIP18)","+",611367,611453,611231,222,"W-open-F",611231,611453,"chrXIII"
"chrXIII","YMR176W (ECM5)","+",616044,616209,615999,210,"F-close-W",615999,616209,"chrXIII"
"chrXIII","YMR177W (MMT1)","+",618182,618205,618076,129,"W-close-W",618076,618205,"chrXIII"
"chrXIII","YMR178W","+",619450,619465,619312,153,"W-close-W",619312,619465,"chrXIII"
"chrXIII","YMR179W (SPT21)","+",622246,622276,622164,112,"F-overlap-W",622164,622276,"chrXIII"
"chrXIII","YMR180C (CTL1 CTH1)","-",622133,622076,622164,88,"F-overlap-F",622076,622164,"chrXIII"
"chrXIII","YMR181C","-",623446,623432,623637,205,"F-close-F",623432,623637,"chrXIII"
"chrXIII","YMR182C (RGM1)","-",624090,624016,624232,216,"W-open-F",624016,624232,"chrXIII"
"chrXIII","YMR182W-A","+",626417,626593,626391,202,"F-close-F",626391,626593,"chrXIII"
"chrXIII","YMR183C (SSO2)","-",626788,626593,626914,321,"F-open-F",626593,626914,"chrXIII"
"chrXIII","YMR184W (ADD37)","+",628831,629044,628713,331,"W-open-W",628713,629044,"chrXIII"
"chrXIII","YMR185W","+",632032,632326,631971,355,"W-open-F",631971,632326,"chrXIII"
"chrXIII","YMR186W (HSC82 HSP90)","+",634563,634642,634422,220,"W-open-F",634422,634642,"chrXIII"
"chrXIII","YMR187C","-",634467,634422,634642,220,"F-open-W",634422,634642,"chrXIII"
"chrXIII","YMR188C (MRPS17)","-",636174,635968,636208,240,"W-open-F",635968,636208,"chrXIII"
"chrXIII","YMR189W (GCV2 GSD2)","+",640683,640728,640636,92,"F-overlap-W",640636,640728,"chrXIII"
"chrXIII","YMR190C (SGS1)","-",640730,640728,640820,92,"F-overlap-W",640728,640820,"chrXIII"
"chrXIII","YMR191W (SPG5)","+",646922,647106,646844,262,"F-open-W",646844,647106,"chrXIII"
"chrXIII","YMR192W (GYL1 APP2)","+",649364,649470,649267,203,"W-close-F",649267,649470,"chrXIII"
"chrXIII","YMR193W (MRPL24 MRPL14)","+",650935,651181,650870,311,"W-open-W",650870,651181,"chrXIII"
"chrXIII","YMR194C-A","-",652463,652458,652637,179,"F-close-F",652458,652637,"chrXIII"
"chrXIII","YMR194C-B (CMC4)","-",652332,652303,652458,155,"F-close-F",652303,652458,"chrXIII"
"chrXIII","YMR194W (RPL36A RPL39B)","+",651984,652015,651816,199,"W-close-F",651816,652015,"chrXIII"
"chrXIII","YMR195W (ICY1)","+",654542,654723,654510,213,"F-close-F",654510,654723,"chrXIII"
"chrXIII","YMR196W","+",658458,658514,658336,178,"W-close-F",658336,658514,"chrXIII"
"chrXIII","YMR197C (VTI1)","-",658369,658336,658514,178,"F-close-W",658336,658514,"chrXIII"
"chrXIII","YMR198W (CIK1)","+",661647,661710,661523,187,"W-close-W",661523,661710,"chrXIII"
"chrXIII","YMR199W (CLN1)","+",664402,664389,664212,177,"W-close-W",664212,664389,"chrXIII"
"chrXIII","YMR200W (ROT1)","+",665788,665831,665674,157,"W-close-F",665674,665831,"chrXIII"
"chrXIII","YMR201C (RAD14)","-",665760,665674,665831,157,"F-close-W",665674,665831,"chrXIII"
"chrXIII","YMR202W (ERG2 END11)","+",668271,668502,668192,310,"W-open-W",668192,668502,"chrXIII"
"chrXIII","YMR203W (TOM40 ISP42 MOM38)","+",669875,670073,669805,268,"F-open-F",669805,670073,"chrXIII"
"chrXIII","YMR204C (INP1)","-",669764,669602,669805,203,"F-close-W",669602,669805,"chrXIII"
"chrXIII","YMR205C (PFK2)","-",671704,671600,671758,158,"F-close-W",671600,671758,"chrXIII"
"chrXIII","YMR206W","+",676914,676959,676797,162,"F-close-W",676797,676959,"chrXIII"
"chrXIII","YMR207C (HFA1)","-",677003,676959,677233,274,"F-open-W",676959,677233,"chrXIII"
"chrXIII","YMR208W (ERG12 RAR1)","+",685907,685951,685774,177,"W-close-F",685774,685951,"chrXIII"
"chrXIII","YMR209C","-",685794,685774,685951,177,"F-close-W",685774,685951,"chrXIII"
"chrXIII","YMR210W","+",688924,689084,688833,251,"W-open-W",688833,689084,"chrXIII"
"chrXIII","YMR211W (DML1)","+",690645,690627,690504,123,"F-close-F",690504,690627,"chrXIII"
"chrXIII","YMR212C (EFR3)","-",690567,690504,690627,123,"F-close-F",690504,690627,"chrXIII"
"chrXIII","YMR213W (CEF1 NTC85)","+",695199,695291,695079,212,"W-close-F",695079,695291,"chrXIII"
"chrXIII","YMR214W (SCJ1)","+",696606,696784,696490,294,"W-open-W",696490,696784,"chrXIII"
"chrXIII","YMR215W (GAS3)","+",698498,698571,698473,98,"F-overlap-F",698473,698571,"chrXIII"
"chrXIII","YMR216C (SKY1)","-",698633,698571,698811,240,"W-open-F",698571,698811,"chrXIII"
"chrXIII","YMR217W (GUA1)","+",703467,703522,703270,252,"F-open-F",703270,703522,"chrXIII"
"chrXIII","YMR218C (TRS130)","-",703360,703270,703522,252,"F-open-F",703270,703522,"chrXIII"
"chrXIII","YMR219W (ESC1)","+",712163,712317,712121,196,"F-close-W",712121,712317,"chrXIII"
"chrXIII","YMR220W (ERG8)","+",713760,713768,713622,146,"F-close-F",713622,713768,"chrXIII"
"chrXIII","YMR221C","-",713842,713768,713947,179,"F-close-F",713768,713947,"chrXIII"
"chrXIII","YMR222C (FSH2)","-",715562,715430,715684,254,"W-open-W",715430,715684,"chrXIII"
"chrXIII","YMR223W (UBP8)","+",718479,718566,718459,107,"F-overlap-F",718459,718566,"chrXIII"
"chrXIII","YMR224C (MRE11 NGS1 RAD58 XRS4)","-",718413,718263,718459,196,"F-close-F",718263,718459,"chrXIII"
"chrXIII","YMR225C (MRPL44 YMR44)","-",720786,720650,720880,230,"W-open-W",720650,720880,"chrXIII"
"chrXIII","YMR226C (TMA29)","-",721528,721383,721639,256,"W-open-W",721383,721639,"chrXIII"
"chrXIII","YMR227C (TAF7 TAF67)","-",722501,722389,722649,260,"W-open-W",722389,722649,"chrXIII"
"chrXIII","YMR228W (MTF1)","+",725748,725826,725645,181,"F-close-F",725645,725826,"chrXIII"
"chrXIII","YMR229C (RRP5)","-",725828,725826,726012,186,"F-close-F",725826,726012,"chrXIII"
"chrXIII","YMR230W (RPS10B)","+",733234,733290,733096,194,"W-close-W",733096,733290,"chrXIII"
"chrXIII","YMR231W (PEP5 END1 VAM1 VPL9 VPS11 VPT11)","+",736822,736808,736547,261,"W-open-W",736547,736808,"chrXIII"
"chrXIII","YMR232W (FUS2)","+",739067,739216,738958,258,"W-open-W",738958,739216,"chrXIII"
"chrXIII","YMR233W (TRI1)","+",740038,740239,739989,250,"W-open-W",739989,740239,"chrXIII"
"chrXIII","YMR234W (RNH1)","+",741433,741468,741269,199,"F-close-F",741269,741468,"chrXIII"
"chrXIII","YMR235C (RNA1)","-",741339,741269,741468,199,"F-close-F",741269,741468,"chrXIII"
"chrXIII","YMR236W (TAF9 TAF17)","+",743557,743715,743446,269,"W-open-W",743446,743715,"chrXIII"
"chrXIII","YMR237W (BCH1)","+",746080,746262,745983,279,"W-open-W",745983,746262,"chrXIII"
"chrXIII","YMR238W (DFG5)","+",747819,748105,747745,360,"F-open-W",747745,748105,"chrXIII"
"chrXIII","YMR239C (RNT1)","-",748113,748105,748283,178,"W-close-W",748105,748283,"chrXIII"
"chrXIII","YMR240C (CUS1)","-",749878,749707,749954,247,"W-open-W",749707,749954,"chrXIII"
"chrXIII","YMR241W (YHM2)","+",752957,753055,752842,213,"W-close-F",752842,753055,"chrXIII"
"chrXIII","YMR242C (RPL20A RPL18A2)","-",753118,753055,753264,209,"W-close-F",753055,753264,"chrXIII"
"chrXIII","YMR243C (ZRC1 OSR1)","-",754669,NA,NA,NA,"+1_missing",754194,754752,"chrXIII"
"chrXIII","YMR244C-A","-",758354,758263,758540,277,"W-open-W",758263,758540,"chrXIII"
"chrXIII","YMR245W","+",759312,759459,759185,274,"W-open-W",759185,759459,"chrXIII"
"chrXIII","YMR246W (FAA4)","+",762071,762119,762029,90,"F-overlap-F",762029,762119,"chrXIII"
"chrXIII","YMR247C (RKR1 LTN1)","-",763276,763069,763363,294,"W-open-W",763069,763363,"chrXIII"
"chrXIII","YMR247W-A","+",769604,769641,769473,168,"F-close-W",769473,769641,"chrXIII"
"chrXIII","YMR250W (GAD1)","+",772670,772800,772566,234,"F-open-F",772566,772800,"chrXIII"
"chrXIII","YMR251W (GTO3)","+",774724,774847,774634,213,"F-close-F",774634,774847,"chrXIII"
"chrXIII","YMR251W-A (HOR7)","+",775213,775259,775049,210,"F-close-F",775049,775259,"chrXIII"
"chrXIII","YMR252C","-",775132,775049,775259,210,"F-close-F",775049,775259,"chrXIII"
"chrXIII","YMR253C","-",775920,775735,776000,265,"W-open-W",775735,776000,"chrXIII"
"chrXIII","YMR254C","-",777578,777578,777749,171,"W-close-W",777578,777749,"chrXIII"
"chrXIII","YMR255W (GFD1)","+",778690,778727,778635,92,"W-overlap-F",778635,778727,"chrXIII"
"chrXIII","YMR256C (COX7)","-",778778,778797,778970,173,"W-close-W",778797,778970,"chrXIII"
"chrXIII","YMR257C (PET111)","-",779388,779116,779419,303,"W-open-W",779116,779419,"chrXIII"
"chrXIII","YMR258C","-",782579,782364,782638,274,"W-open-W",782364,782638,"chrXIII"
"chrXIII","YMR259C","-",784554,784536,784726,190,"W-close-W",784536,784726,"chrXIII"
"chrXIII","YMR260C (TIF11)","-",789227,789150,789341,191,"W-close-W",789150,789341,"chrXIII"
"chrXIII","YMR261C (TPS3)","-",790060,789824,790129,305,"W-open-W",789824,790129,"chrXIII"
"chrXIII","YMR262W","+",794887,794930,794644,286,"W-open-W",794644,794930,"chrXIII"
"chrXIII","YMR263W (SAP30)","+",795608,795793,795541,252,"W-open-W",795541,795793,"chrXIII"
"chrXIII","YMR264W (CUE1 KIS4)","+",796545,796628,796465,163,"W-close-F",796465,796628,"chrXIII"
"chrXIII","YMR265C","-",796407,796314,796465,151,"W-close-W",796314,796465,"chrXIII"
"chrXIII","YMR266W (RSN1)","+",801566,801555,801441,114,"F-overlap-F",801441,801555,"chrXIII"
"chrXIII","YMR267W (PPA2 IPP2)","+",802841,802909,802771,138,"W-close-W",802771,802909,"chrXIII"
"chrXIII","YMR268C (PRP24)","-",802722,802615,802771,156,"W-close-W",802615,802771,"chrXIII"
"chrXIII","YMR269W (TMA23 YMR268W-A)","+",805154,805348,805059,289,"F-open-F",805059,805348,"chrXIII"
"chrXIII","YMR270C (RRN9)","-",805182,805059,805348,289,"F-open-F",805059,805348,"chrXIII"
"chrXIII","YMR271C (URA10)","-",806734,806733,806922,189,"W-close-W",806733,806922,"chrXIII"
"chrXIII","YMR272C (SCS7 FAH1)","-",809448,809321,809487,166,"F-close-W",809321,809487,"chrXIII"
"chrXIII","YMR272W-B","+",811419,811487,811323,164,"W-close-W",811323,811487,"chrXIII"
"chrXIII","YMR273C (ZDS1 CES1 CKM1 NRC1 OSS1)","-",811158,811159,811323,164,"W-close-W",811159,811323,"chrXIII"
"chrXIII","YMR274C (RCE1)","-",814301,814145,814421,276,"W-open-W",814145,814421,"chrXIII"
"chrXIII","YMR275C (BUL1 DAG1 RDS1 SMM2)","-",815524,815526,815724,198,"W-close-F",815526,815724,"chrXIII"
"chrXIII","YMR276W (DSK2)","+",820056,820207,819932,275,"W-open-W",819932,820207,"chrXIII"
"chrXIII","YMR277W (FCP1)","+",822575,822748,822519,229,"W-open-W",822519,822748,"chrXIII"
"chrXIII","YMR278W (PGM3)","+",824738,824841,824713,128,"F-close-F",824713,824841,"chrXIII"
"chrXIII","YMR279C","-",824662,824609,824713,104,"F-overlap-F",824609,824713,"chrXIII"
"chrXIII","YMR281W (GPI12)","+",833348,833368,833148,220,"W-open-W",833148,833368,"chrXIII"
"chrXIII","YMR282C (AEP2 ATP13)","-",833223,833148,833368,220,"W-open-W",833148,833368,"chrXIII"
"chrXIII","YMR283C (RIT1)","-",835249,835090,835361,271,"W-open-W",835090,835361,"chrXIII"
"chrXIII","YMR284W (YKU70 HDF1 KU70 NES24)","+",840132,840180,839993,187,"F-close-F",839993,840180,"chrXIII"
"chrXIII","YMR285C (NGL2)","-",839994,839993,840180,187,"F-close-F",839993,840180,"chrXIII"
"chrXIII","YMR286W (MRPL33)","+",842335,842493,842281,212,"F-close-W",842281,842493,"chrXIII"
"chrXIII","YMR287C (DSS1 MSU1)","-",842335,842281,842493,212,"W-close-F",842281,842493,"chrXIII"
"chrXIII","YMR288W (HSH155)","+",848540,848738,848478,260,"W-open-F",848478,848738,"chrXIII"
"chrXIII","YMR289W (ABZ2)","+",849960,849954,849868,86,"F-overlap-F",849868,849954,"chrXIII"
"chrXIII","YMR290C (HAS1)","-",849856,849868,849954,86,"F-overlap-F",849868,849954,"chrXIII"
"chrXIII","YMR291W","+",854568,854785,854505,280,"F-open-W",854505,854785,"chrXIII"
"chrXIII","YMR292W (GOT1)","+",855394,855456,855284,172,"W-close-W",855284,855456,"chrXIII"
"chrXIII","YMR293C (HER2 GEP6 LRC6 RRG6)","-",855306,855284,855456,172,"W-close-W",855284,855456,"chrXIII"
"chrXIII","YMR294W (JNM1 INS1 PAC3)","+",858145,858289,858106,183,"F-close-F",858106,858289,"chrXIII"
"chrXIII","YMR295C","-",858107,858106,858289,183,"F-close-F",858106,858289,"chrXIII"
"chrXIII","YMR296C (LCB1 END8 TSC2)","-",859131,859093,859263,170,"W-close-F",859093,859263,"chrXIII"
"chrXIII","YMR297W (PRC1 LBC1)","+",863637,863829,863560,269,"W-open-W",863560,863829,"chrXIII"
"chrXIII","YMR298W (LIP1)","+",864390,864481,864337,144,"W-close-W",864337,864481,"chrXIII"
"chrXIII","YMR299C (DYN3)","-",864299,864174,864337,163,"W-close-W",864174,864337,"chrXIII"
"chrXIII","YMR300C (ADE4)","-",865484,865340,865564,224,"W-open-W",865340,865564,"chrXIII"
"chrXIII","YMR301C (ATM1)","-",867487,867347,867609,262,"W-open-F",867347,867609,"chrXIII"
"chrXIII","YMR302C (YME2 PRP12 RNA12)","-",869972,869899,870072,173,"F-close-W",869899,870072,"chrXIII"
"chrXIII","YMR303C (ADH2 ADR2)","-",873176,873176,873371,195,"W-close-W",873176,873371,"chrXIII"
"chrXIII","YMR304W (UBP15)","+",878899,878916,878817,99,"F-overlap-F",878817,878916,"chrXIII"
"chrXIII","YMR305C (SCW10)","-",878875,878817,878916,99,"F-overlap-F",878817,878916,"chrXIII"
"chrXIII","YMR307W (GAS1 CWH52 GGP1)","+",888851,889007,888631,376,"F-open-F",888631,889007,"chrXIII"
"chrXIII","YMR308C (PSE1 KAP121)","-",888877,888631,889007,376,"F-open-F",888631,889007,"chrXIII"
"chrXIII","YMR309C (NIP1)","-",892760,892600,892802,202,"F-close-W",892600,892802,"chrXIII"
"chrXIII","YMR310C","-",895648,895441,895749,308,"W-open-W",895441,895749,"chrXIII"
"chrXIII","YMR311C (GLC8)","-",896803,896692,896938,246,"W-open-W",896692,896938,"chrXIII"
"chrXIII","YMR312W (ELP6 HAP3 KTI4 TOT6)","+",899332,899437,899247,190,"F-close-F",899247,899437,"chrXIII"
"chrXIII","YMR313C (TGL3)","-",899221,899139,899247,108,"F-overlap-F",899139,899247,"chrXIII"
"chrXIII","YMR314W (PRE5)","+",902571,902775,902421,354,"W-open-W",902421,902775,"chrXIII"
"chrXIII","YMR315W","+",903960,904085,903914,171,"F-close-F",903914,904085,"chrXIII"
"chrXIII","YMR315W-A","+",904763,904747,904481,266,"F-open-W",904481,904747,"chrXIII"
"chrXIII","YMR316C-A","-",905016,904926,905095,169,"F-close-W",904926,905095,"chrXIII"
"chrXIII","YMR316C-B","-",907180,907162,907258,96,"F-overlap-W",907162,907258,"chrXIII"
"chrXIII","YMR316W (DIA1)","+",905904,905949,905795,154,"F-close-W",905795,905949,"chrXIII"
"chrXIII","YMR317W","+",910968,910969,910766,203,"W-close-F",910766,910969,"chrXIII"
"chrXIII","YMR318C (ADH6 ADHVI)","-",910909,910766,910969,203,"F-close-W",910766,910969,"chrXIII"
"chrXIII","YMR319C (FET4)","-",912654,912522,912678,156,"W-close-W",912522,912678,"chrXIII"
"chrXIV","YNL001W (DOM34)","+",628683,628825,628619,206,"W-close-W",628619,628825,"chrXIV"
"chrXIV","YNL002C (RLP7 RPL7)","-",626109,626101,626287,186,"W-close-W",626101,626287,"chrXIV"
"chrXIV","YNL003C (PET8 SAM5)","-",624789,624784,625005,221,"F-open-F",624784,625005,"chrXIV"
"chrXIV","YNL004W (HRB1 TOM34)","+",624759,624784,624644,140,"W-close-F",624644,624784,"chrXIV"
"chrXIV","YNL005C (MRP7 MRPL2)","-",621237,621176,621279,103,"F-overlap-F",621176,621279,"chrXIV"
"chrXIV","YNL006W (LST8)","+",621187,621176,621081,95,"W-overlap-F",621081,621176,"chrXIV"
"chrXIV","YNL007C (SIS1)","-",618450,618235,618549,314,"W-open-W",618235,618549,"chrXIV"
"chrXIV","YNL008C (ASI3)","-",616172,616064,616259,195,"F-close-W",616064,616259,"chrXIV"
"chrXIV","YNL009W (IDP3)","+",616698,616786,616593,193,"F-close-F",616593,616786,"chrXIV"
"chrXIV","YNL010W","+",614497,614649,614360,289,"W-open-W",614360,614649,"chrXIV"
"chrXIV","YNL011C","-",611755,611688,611867,179,"W-close-F",611688,611867,"chrXIV"
"chrXIV","YNL012W (SPO1)","+",611824,611867,611688,179,"F-close-W",611688,611867,"chrXIV"
"chrXIV","YNL014W (HEF3 ZRG7)","+",609577,609703,609449,254,"W-open-W",609449,609703,"chrXIV"
"chrXIV","YNL015W (PBI2 I2B IB2 LMA1)","+",605699,605842,605658,184,"W-close-W",605658,605842,"chrXIV"
"chrXIV","YNL016W (PUB1 RNP1)","+",604589,604677,604499,178,"F-close-F",604499,604677,"chrXIV"
"chrXIV","YNL019C","-",598266,598205,598348,143,"F-close-W",598205,598348,"chrXIV"
"chrXIV","YNL020C (ARK1)","-",595471,595321,595638,317,"W-open-F",595321,595638,"chrXIV"
"chrXIV","YNL021W (HDA1)","+",595601,595638,595321,317,"F-open-W",595321,595638,"chrXIV"
"chrXIV","YNL022C","-",591332,591177,591453,276,"W-open-W",591177,591453,"chrXIV"
"chrXIV","YNL023C (FAP1)","-",588180,588108,588279,171,"F-close-W",588108,588279,"chrXIV"
"chrXIV","YNL024C","-",587004,586852,587128,276,"W-open-W",586852,587128,"chrXIV"
"chrXIV","YNL024C-A (KSH1)","-",586333,586281,586494,213,"W-close-W",586281,586494,"chrXIV"
"chrXIV","YNL025C (SSN8 CycC GIG3 NUT9 RYE2 SRB11 UME3)","-",583623,583538,583696,158,"F-close-F",583538,583696,"chrXIV"
"chrXIV","YNL026W (SAM50 OMP85 TOB55)","+",583496,583538,583461,77,"F-overlap-F",583461,583538,"chrXIV"
"chrXIV","YNL027W (CRZ1 HAL8 TCN1)","+",581721,581943,581675,268,"W-open-W",581675,581943,"chrXIV"
"chrXIV","YNL029C (KTR5)","-",577124,577089,577299,210,"W-close-F",577089,577299,"chrXIV"
"chrXIV","YNL030W (HHF2)","+",577214,577299,577089,210,"F-close-W",577089,577299,"chrXIV"
"chrXIV","YNL031C (HHT2)","-",575390,575271,575414,143,"F-close-W",575271,575414,"chrXIV"
"chrXIV","YNL032W (SIW14 OCA3)","+",575481,575573,575414,159,"F-close-F",575414,575573,"chrXIV"
"chrXIV","YNL033W","+",573964,574131,573937,194,"W-close-W",573937,574131,"chrXIV"
"chrXIV","YNL035C","-",568308,568113,568427,314,"W-open-F",568113,568427,"chrXIV"
"chrXIV","YNL036W (NCE103 NCE3)","+",560539,560585,560514,71,"F-overlap-F",560514,560585,"chrXIV"
"chrXIV","YNL037C (IDH1)","-",557794,557740,557857,117,"F-overlap-W",557740,557857,"chrXIV"
"chrXIV","YNL038W (GPI15)","+",557896,557963,557857,106,"F-overlap-F",557857,557963,"chrXIV"
"chrXIV","YNL039W (BDP1 TFC5 TFC7)","+",556922,557062,556789,273,"W-open-W",556789,557062,"chrXIV"
"chrXIV","YNL040W","+",554903,555061,554771,290,"W-open-W",554771,555061,"chrXIV"
"chrXIV","YNL041C (COG6 COD2 SEC37)","-",549289,549207,549438,231,"F-open-W",549207,549438,"chrXIV"
"chrXIV","YNL042W (BOP3)","+",549388,549438,549207,231,"W-open-F",549207,549438,"chrXIV"
"chrXIV","YNL043C","-",545123,544964,545241,277,"W-open-W",544964,545241,"chrXIV"
"chrXIV","YNL044W (YIP3)","+",546039,546240,545993,247,"F-open-F",545993,546240,"chrXIV"
"chrXIV","YNL045W (LAP2)","+",545050,545241,544964,277,"W-open-W",544964,545241,"chrXIV"
"chrXIV","YNL046W","+",542957,542958,542746,212,"W-close-F",542746,542958,"chrXIV"
"chrXIV","YNL047C (SLM2 LIT1)","-",539828,539707,539878,171,"F-close-F",539707,539878,"chrXIV"
"chrXIV","YNL048W (ALG11)","+",539919,539978,539878,100,"F-overlap-W",539878,539978,"chrXIV"
"chrXIV","YNL049C (SFB2 ISS1)","-",535172,534963,535205,242,"W-open-W",534963,535205,"chrXIV"
"chrXIV","YNL050C","-",534011,533867,534140,273,"F-open-F",533867,534140,"chrXIV"
"chrXIV","YNL051W (COG5 API4 COD4)","+",533916,534140,533867,273,"F-open-F",533867,534140,"chrXIV"
"chrXIV","YNL052W (COX5A)","+",532454,532499,532289,210,"W-close-F",532289,532499,"chrXIV"
"chrXIV","YNL053W (MSG5)","+",531545,531736,531470,266,"W-open-W",531470,531736,"chrXIV"
"chrXIV","YNL054W (VAC7)","+",529842,529859,NA,NA,"-1_missing",529517,529859,"chrXIV"
"chrXIV","YNL055C (POR1 OMP2 VDAC YVDAC1)","-",517925,517891,518064,173,"F-close-F",517891,518064,"chrXIV"
"chrXIV","YNL056W (OCA2)","+",517958,518064,517891,173,"F-close-F",517891,518064,"chrXIV"
"chrXIV","YNL057W","+",516864,517017,516779,238,"W-open-F",516779,517017,"chrXIV"
"chrXIV","YNL058C","-",515656,515516,515680,164,"W-close-W",515516,515680,"chrXIV"
"chrXIV","YNL059C (ARP5)","-",512551,512334,512603,269,"F-open-F",512334,512603,"chrXIV"
"chrXIV","YNL061W (NOP2 YNA1)","+",512550,512603,512334,269,"F-open-F",512334,512603,"chrXIV"
"chrXIV","YNL062C (GCD10 TRM6)","-",508621,508637,508834,197,"F-close-W",508637,508834,"chrXIV"
"chrXIV","YNL063W (MTQ1)","+",508753,508834,508637,197,"W-close-F",508637,508834,"chrXIV"
"chrXIV","YNL064C (YDJ1 HSP40 MAS5)","-",505737,505694,505771,77,"F-overlap-F",505694,505771,"chrXIV"
"chrXIV","YNL065W (AQR1)","+",505611,505694,505481,213,"F-close-F",505481,505694,"chrXIV"
"chrXIV","YNL066W (SUN4 SCW3)","+",502975,NA,NA,NA,"+1_missing",502876,503350,"chrXIV"
"chrXIV","YNL067W (RPL9B)","+",500486,500654,500406,248,"W-open-F",500406,500654,"chrXIV"
"chrXIV","YNL068C (FKH2)","-",495531,495325,495562,237,"W-open-F",495325,495562,"chrXIV"
"chrXIV","YNL069C (RPL16B RP23)","-",493792,493678,493842,164,"W-close-F",493678,493842,"chrXIV"
"chrXIV","YNL070W (TOM7 MOM7 YOK22)","+",493694,493678,493519,159,"W-close-F",493519,493678,"chrXIV"
"chrXIV","YNL071W (LAT1 ODP2 PDA2)","+",493126,493339,493055,284,"F-open-W",493055,493339,"chrXIV"
"chrXIV","YNL072W (RNH201 RNH35)","+",491316,491474,491210,264,"W-open-W",491210,491474,"chrXIV"
"chrXIV","YNL073W (MSK1)","+",490209,490347,490085,262,"W-open-W",490085,490347,"chrXIV"
"chrXIV","YNL074C (MLF3 YMK1)","-",486609,486412,486796,384,"F-open-W",486412,486796,"chrXIV"
"chrXIV","YNL075W (IMP4)","+",486552,486796,486412,384,"W-open-F",486412,486796,"chrXIV"
"chrXIV","YNL076W (MKS1 LYS80)","+",485371,485593,485296,297,"W-open-W",485296,485593,"chrXIV"
"chrXIV","YNL077W (APJ1)","+",483068,483090,482906,184,"W-close-W",482906,483090,"chrXIV"
"chrXIV","YNL078W (NIS1 JIP1)","+",481142,481149,480961,188,"W-close-F",480961,481149,"chrXIV"
"chrXIV","YNL079C (TPM1)","-",478386,478174,478462,288,"W-open-W",478174,478462,"chrXIV"
"chrXIV","YNL080C (EOS1)","-",476826,476602,476881,279,"W-open-W",476602,476881,"chrXIV"
"chrXIV","YNL081C (SWS2)","-",476002,475941,476118,177,"W-close-W",475941,476118,"chrXIV"
"chrXIV","YNL082W (PMS1)","+",476095,476118,475941,177,"W-close-W",475941,476118,"chrXIV"
"chrXIV","YNL083W (SAL1)","+",473146,473199,473124,75,"W-overlap-F",473124,473199,"chrXIV"
"chrXIV","YNL084C (END3)","-",469976,469975,470141,166,"W-close-F",469975,470141,"chrXIV"
"chrXIV","YNL085W (MKT1)","+",469918,469975,469774,201,"W-close-F",469774,469975,"chrXIV"
"chrXIV","YNL086W (SNN1 BLS1)","+",466735,466858,466597,261,"W-open-W",466597,466858,"chrXIV"
"chrXIV","YNL087W (TCB2)","+",466131,466266,466056,210,"W-close-F",466056,466266,"chrXIV"
"chrXIV","YNL088W (TOP2 TOR3 TRF3)","+",462115,462316,462015,301,"W-open-F",462015,462316,"chrXIV"
"chrXIV","YNL089C","-",456404,456177,456463,286,"W-open-W",456177,456463,"chrXIV"
"chrXIV","YNL090W (RHO2)","+",457369,457383,457238,145,"W-close-W",457238,457383,"chrXIV"
"chrXIV","YNL091W (NST1)","+",456202,456463,456177,286,"W-open-W",456177,456463,"chrXIV"
"chrXIV","YNL092W","+",452172,452296,452014,282,"W-open-W",452014,452296,"chrXIV"
"chrXIV","YNL093W (YPT53)","+",450805,450851,450572,279,"W-open-W",450572,450851,"chrXIV"
"chrXIV","YNL094W (APP1)","+",449517,449526,449413,113,"W-overlap-F",449413,449526,"chrXIV"
"chrXIV","YNL095C","-",444725,NA,NA,NA,"+1_missing",444314,444792,"chrXIV"
"chrXIV","YNL096C (RPS7B)","-",443196,443154,443232,78,"F-overlap-F",443154,443232,"chrXIV"
"chrXIV","YNL097C (PHO23)","-",441246,441208,441371,163,"W-close-F",441208,441371,"chrXIV"
"chrXIV","YNL097C-B (YNL097C-A)","-",440581,440564,440781,217,"W-open-F",440564,440781,"chrXIV"
"chrXIV","YNL097W-A","+",441607,441681,441520,161,"W-close-F",441520,441681,"chrXIV"
"chrXIV","YNL098C (RAS2 CTN5 CYR3 GLC5 TSL7)","-",439482,439280,439549,269,"F-open-W",439280,439549,"chrXIV"
"chrXIV","YNL099C (OCA1)","-",438305,438276,438457,181,"F-close-W",438276,438457,"chrXIV"
"chrXIV","YNL100W (AIM37)","+",438433,438457,438276,181,"W-close-F",438276,438457,"chrXIV"
"chrXIV","YNL101W (AVT4)","+",437338,437325,437168,157,"W-close-W",437168,437325,"chrXIV"
"chrXIV","YNL102W (POL1 CDC17 CRT5 HPR3)","+",434573,434558,434389,169,"W-close-W",434389,434558,"chrXIV"
"chrXIV","YNL103W (MET4)","+",429836,430048,429784,264,"F-open-W",429784,430048,"chrXIV"
"chrXIV","YNL104C (LEU4)","-",424779,424544,424841,297,"F-open-W",424544,424841,"chrXIV"
"chrXIV","YNL106C (INP52 SJL2)","-",420862,420798,420951,153,"F-close-W",420798,420951,"chrXIV"
"chrXIV","YNL107W (YAF9)","+",420954,420951,420798,153,"W-close-F",420798,420951,"chrXIV"
"chrXIV","YNL108C (HUF)","-",418860,418813,419006,193,"W-close-W",418813,419006,"chrXIV"
"chrXIV","YNL109W","+",419885,420087,419811,276,"W-open-W",419811,420087,"chrXIV"
"chrXIV","YNL110C (NOP15)","-",417711,417487,417837,350,"W-open-F",417487,417837,"chrXIV"
"chrXIV","YNL111C (CYB5)","-",416699,416655,416828,173,"F-close-W",416655,416828,"chrXIV"
"chrXIV","YNL112W (DBP2)","+",416414,416422,416210,212,"W-close-F",416210,416422,"chrXIV"
"chrXIV","YNL113W (RPC19)","+",413378,413603,413241,362,"W-open-W",413241,413603,"chrXIV"
"chrXIV","YNL114C","-",412381,412293,412497,204,"W-close-W",412293,412497,"chrXIV"
"chrXIV","YNL115C","-",409966,409888,410005,117,"F-overlap-F",409888,410005,"chrXIV"
"chrXIV","YNL116W (DMA2 CHF2)","+",410068,410087,410005,82,"F-overlap-F",410005,410087,"chrXIV"
"chrXIV","YNL117W (MLS1)","+",408111,408339,408031,308,"W-open-W",408031,408339,"chrXIV"
"chrXIV","YNL118C (DCP2 PSU1)","-",402505,402374,402526,152,"F-close-F",402374,402526,"chrXIV"
"chrXIV","YNL119W (NCS2 TUC2)","+",402653,402713,402526,187,"F-close-F",402526,402713,"chrXIV"
"chrXIV","YNL121C (TOM70 MAS70 MOM72 OMP1)","-",398463,398302,398580,278,"F-open-W",398302,398580,"chrXIV"
"chrXIV","YNL122C","-",397840,397783,397947,164,"W-close-W",397783,397947,"chrXIV"
"chrXIV","YNL123W (NMA111 YNM3)","+",397742,397783,397614,169,"W-close-W",397614,397783,"chrXIV"
"chrXIV","YNL124W (NAF1)","+",394475,394693,394386,307,"W-open-W",394386,394693,"chrXIV"
"chrXIV","YNL125C (ESBP6 MCH3)","-",390029,390017,390118,101,"F-overlap-F",390017,390118,"chrXIV"
"chrXIV","YNL126W (SPC98)","+",389843,389854,389777,77,"F-overlap-F",389777,389854,"chrXIV"
"chrXIV","YNL127W (FAR11)","+",387084,387219,386966,253,"W-open-W",386966,387219,"chrXIV"
"chrXIV","YNL128W (TEP1)","+",383881,383948,383706,242,"W-open-W",383706,383948,"chrXIV"
"chrXIV","YNL129W (NRK1)","+",382325,382332,382122,210,"W-close-W",382122,382332,"chrXIV"
"chrXIV","YNL130C (CPT1)","-",379461,379418,379540,122,"F-close-W",379418,379540,"chrXIV"
"chrXIV","YNL131W (TOM22 MAS17 MAS22 MOM22)","+",379545,379540,379418,122,"W-close-F",379418,379540,"chrXIV"
"chrXIV","YNL132W (KRE33)","+",378578,378779,378484,295,"W-open-W",378484,378779,"chrXIV"
"chrXIV","YNL133C (FYV6)","-",374057,373957,374149,192,"W-close-W",373957,374149,"chrXIV"
"chrXIV","YNL134C","-",372388,372347,372513,166,"W-close-F",372347,372513,"chrXIV"
"chrXIV","YNL135C (FPR1 FKB1 RBP1)","-",371705,371686,371887,201,"W-close-W",371686,371887,"chrXIV"
"chrXIV","YNL136W (EAF7)","+",371769,371887,371686,201,"W-close-W",371686,371887,"chrXIV"
"chrXIV","YNL137C (NAM9 MNA6)","-",368376,368332,368430,98,"F-overlap-F",368332,368430,"chrXIV"
"chrXIV","YNL138W (SRV2 CAP)","+",368466,368520,368430,90,"F-overlap-F",368430,368520,"chrXIV"
"chrXIV","YNL138W-A (YSF3 RCP10)","+",366610,366752,366462,290,"W-open-W",366462,366752,"chrXIV"
"chrXIV","YNL139C (THO2 LDB5 RLR1 ZRG13)","-",360604,360566,360779,213,"F-close-W",360566,360779,"chrXIV"
"chrXIV","YNL141W (AAH1)","+",360733,360779,360566,213,"W-close-F",360566,360779,"chrXIV"
"chrXIV","YNL142W (MEP2)","+",359041,359100,358874,226,"F-open-F",358874,359100,"chrXIV"
"chrXIV","YNL144C","-",352757,352677,352887,210,"W-close-F",352677,352887,"chrXIV"
"chrXIV","YNL145W (MFA2)","+",352702,352887,352677,210,"F-close-W",352677,352887,"chrXIV"
"chrXIV","YNL146C-A","-",350982,350924,351103,179,"W-close-W",350924,351103,"chrXIV"
"chrXIV","YNL146W","+",352327,352316,NA,NA,"-1_missing",351986,352316,"chrXIV"
"chrXIV","YNL147W (LSM7)","+",351431,351657,351391,266,"W-open-W",351391,351657,"chrXIV"
"chrXIV","YNL148C (ALF1)","-",349782,349760,NA,NA,"-1_missing",349760,350327,"chrXIV"
"chrXIV","YNL149C (PGA2)","-",349256,349250,349424,174,"W-close-W",349250,349424,"chrXIV"
"chrXIV","YNL150W","+",349775,349760,349581,179,"W-close-W",349581,349760,"chrXIV"
"chrXIV","YNL151C (RPC31 ACP2 RPC8)","-",347621,347484,347719,235,"F-open-F",347484,347719,"chrXIV"
"chrXIV","YNL152W (INN1)","+",347621,347719,347484,235,"F-open-F",347484,347719,"chrXIV"
"chrXIV","YNL153C (GIM3 PFD4)","-",345440,345295,345470,175,"F-close-W",345295,345470,"chrXIV"
"chrXIV","YNL154C (YCK2)","-",343442,343259,343470,211,"F-close-W",343259,343470,"chrXIV"
"chrXIV","YNL155W","+",343450,343470,343259,211,"W-close-F",343259,343470,"chrXIV"
"chrXIV","YNL156C (NSG2)","-",340951,340841,340998,157,"F-close-W",340841,340998,"chrXIV"
"chrXIV","YNL157W (IGO1)","+",340939,340998,340841,157,"W-close-F",340841,340998,"chrXIV"
"chrXIV","YNL158W (PGA1)","+",340307,340356,340143,213,"F-close-W",340143,340356,"chrXIV"
"chrXIV","YNL159C (ASI2)","-",338017,338028,338099,71,"F-overlap-W",338028,338099,"chrXIV"
"chrXIV","YNL160W (YGP1)","+",337837,337959,337797,162,"F-close-F",337797,337959,"chrXIV"
"chrXIV","YNL161W (CBK1)","+",334956,335029,334811,218,"W-open-F",334811,335029,"chrXIV"
"chrXIV","YNL162W (RPL42A)","+",332244,332433,332127,306,"W-open-W",332127,332433,"chrXIV"
"chrXIV","YNL162W-A","+",330922,NA,NA,NA,"+1_missing",330820,331308,"chrXIV"
"chrXIV","YNL163C (RIA1 EFL1)","-",326611,326439,326729,290,"F-open-W",326439,326729,"chrXIV"
"chrXIV","YNL164C (IBD2)","-",325142,325128,325249,121,"F-close-F",325128,325249,"chrXIV"
"chrXIV","YNL165W","+",325203,325249,325128,121,"F-close-F",325128,325249,"chrXIV"
"chrXIV","YNL166C (BNI5)","-",322121,322139,322296,157,"W-close-F",322139,322296,"chrXIV"
"chrXIV","YNL167C (SKO1 ACR1)","-",319210,319041,319237,196,"W-close-W",319041,319237,"chrXIV"
"chrXIV","YNL168C (FMP41)","-",317874,317737,318020,283,"W-open-W",317737,318020,"chrXIV"
"chrXIV","YNL169C (PSD1)","-",316065,315988,316156,168,"F-close-F",315988,316156,"chrXIV"
"chrXIV","YNL172W (APC1)","+",316111,316156,315988,168,"F-close-F",315988,316156,"chrXIV"
"chrXIV","YNL173C (MDG1)","-",308854,308606,308902,296,"F-open-W",308606,308902,"chrXIV"
"chrXIV","YNL174W","+",308704,308902,308606,296,"W-open-F",308606,308902,"chrXIV"
"chrXIV","YNL175C (NOP13)","-",307280,307128,307408,280,"W-open-W",307128,307408,"chrXIV"
"chrXIV","YNL176C","-",304819,304617,304866,249,"W-open-W",304617,304866,"chrXIV"
"chrXIV","YNL177C (MRPL22)","-",303499,303510,303648,138,"W-close-F",303510,303648,"chrXIV"
"chrXIV","YNL178W (RPS3 SUF14)","+",303461,303510,303325,185,"W-close-F",303325,303510,"chrXIV"
"chrXIV","YNL179C (SRF6)","-",299711,299524,299740,216,"F-open-F",299524,299740,"chrXIV"
"chrXIV","YNL180C (RHO5)","-",299563,299524,299740,216,"F-open-F",299524,299740,"chrXIV"
"chrXIV","YNL181W","+",299655,299740,299524,216,"F-open-F",299524,299740,"chrXIV"
"chrXIV","YNL182C (IPI3)","-",295875,295681,295991,310,"W-open-W",295681,295991,"chrXIV"
"chrXIV","YNL183C (NPR1)","-",293022,293013,293196,183,"W-close-W",293013,293196,"chrXIV"
"chrXIV","YNL185C (MRPL19)","-",292066,292052,292199,147,"W-close-F",292052,292199,"chrXIV"
"chrXIV","YNL186W (UBP10 DOT4)","+",292008,292052,291828,224,"F-open-F",291828,292052,"chrXIV"
"chrXIV","YNL187W (SWT21)","+",289430,289504,289332,172,"W-close-W",289332,289504,"chrXIV"
"chrXIV","YNL188W (KAR1)","+",287631,287834,287606,228,"W-open-W",287606,287834,"chrXIV"
"chrXIV","YNL189W (SRP1 KAP60 SCM1)","+",286021,286013,285840,173,"W-close-W",285840,286013,"chrXIV"
"chrXIV","YNL190W","+",283574,283602,283417,185,"W-close-W",283417,283602,"chrXIV"
"chrXIV","YNL191W (DUG3)","+",281594,NA,NA,NA,"+1_missing",281539,282061,"chrXIV"
"chrXIV","YNL192W (CHS1 USA4)","+",279982,280132,279871,261,"F-open-W",279871,280132,"chrXIV"
"chrXIV","YNL193W","+",276100,276389,275992,397,"W-open-W",275992,276389,"chrXIV"
"chrXIV","YNL195C","-",271434,271383,271594,211,"W-close-W",271383,271594,"chrXIV"
"chrXIV","YNL196C (SLZ1)","-",270242,270209,270382,173,"W-close-W",270209,270382,"chrXIV"
"chrXIV","YNL197C (WHI3)","-",266916,266921,267091,170,"W-close-W",266921,267091,"chrXIV"
"chrXIV","YNL199C (GCR2)","-",264749,264767,264940,173,"W-close-W",264767,264940,"chrXIV"
"chrXIV","YNL200C","-",263633,263449,263730,281,"W-open-W",263449,263730,"chrXIV"
"chrXIV","YNL201C (PSY2)","-",260432,260437,260635,198,"W-close-W",260437,260635,"chrXIV"
"chrXIV","YNL202W (SPS19 SPX19)","+",260554,260635,260437,198,"W-close-W",260437,260635,"chrXIV"
"chrXIV","YNL203C","-",258949,258952,259108,156,"W-close-W",258952,259108,"chrXIV"
"chrXIV","YNL206C (RTT106)","-",256715,256692,256768,76,"F-overlap-F",256692,256768,"chrXIV"
"chrXIV","YNL207W (RIO2)","+",256784,256768,256692,76,"F-overlap-F",256692,256768,"chrXIV"
"chrXIV","YNL208W","+",255128,255246,254976,270,"W-open-W",254976,255246,"chrXIV"
"chrXIV","YNL209W (SSB2 YG103)","+",254019,254098,253852,246,"F-open-W",253852,254098,"chrXIV"
"chrXIV","YNL211C","-",249838,249806,250007,201,"W-close-W",249806,250007,"chrXIV"
"chrXIV","YNL212W (VID27)","+",249956,250007,249806,201,"W-close-W",249806,250007,"chrXIV"
"chrXIV","YNL213C (RRG9)","-",246342,246312,246499,187,"W-close-W",246312,246499,"chrXIV"
"chrXIV","YNL214W (PEX17 PAS9)","+",246472,246499,246312,187,"W-close-W",246312,246499,"chrXIV"
"chrXIV","YNL215W (IES2)","+",245489,245648,245398,250,"W-open-W",245398,245648,"chrXIV"
"chrXIV","YNL216W (RAP1 GRF1 TBA1 TUF1)","+",244308,244450,244217,233,"W-open-W",244217,244450,"chrXIV"
"chrXIV","YNL217W","+",241418,241649,241362,287,"F-open-W",241362,241649,"chrXIV"
"chrXIV","YNL218W (MGS1)","+",240182,240240,240061,179,"F-close-W",240061,240240,"chrXIV"
"chrXIV","YNL219C (ALG9)","-",235835,235783,235856,73,"F-overlap-F",235783,235856,"chrXIV"
"chrXIV","YNL220W (ADE12 BRA9)","+",235821,235856,235783,73,"F-overlap-F",235783,235856,"chrXIV"
"chrXIV","YNL221C (POP1)","-",230926,230654,230954,300,"W-open-W",230654,230954,"chrXIV"
"chrXIV","YNL222W (SSU72)","+",229890,229994,229836,158,"W-close-F",229836,229994,"chrXIV"
"chrXIV","YNL223W (ATG4 APG4 AUT2)","+",228922,229115,228823,292,"W-open-W",228823,229115,"chrXIV"
"chrXIV","YNL224C (SQS1 PFA1)","-",224659,224659,224729,70,"W-overlap-F",224659,224729,"chrXIV"
"chrXIV","YNL225C (CNM67)","-",222617,222444,222660,216,"W-open-W",222444,222660,"chrXIV"
"chrXIV","YNL227C (JJJ1)","-",220587,220371,220662,291,"W-open-W",220371,220662,"chrXIV"
"chrXIV","YNL228W","+",221606,221616,221447,169,"F-close-F",221447,221616,"chrXIV"
"chrXIV","YNL229C (URE2 %5BURE3%5D)","-",218988,218938,219132,194,"W-close-W",218938,219132,"chrXIV"
"chrXIV","YNL230C (ELA1)","-",217144,217049,NA,NA,"-1_missing",217049,217456,"chrXIV"
"chrXIV","YNL231C (PDR16 SFH3)","-",215910,215762,216026,264,"F-open-F",215762,216026,"chrXIV"
"chrXIV","YNL232W (CSL4 SKI4)","+",215873,216026,215762,264,"F-open-F",215762,216026,"chrXIV"
"chrXIV","YNL233W (BNI4)","+",214685,214922,214625,297,"W-open-W",214625,214922,"chrXIV"
"chrXIV","YNL234W","+",211589,211777,211524,253,"W-open-W",211524,211777,"chrXIV"
"chrXIV","YNL236W (SIN4 BEL2 GAL22 MED16 RYE1 SDI3 SSF5 SSN4 TSF3)","+",209945,210218,209811,407,"W-open-W",209811,210218,"chrXIV"
"chrXIV","YNL237W (YTP1)","+",206751,206952,206697,255,"W-open-W",206697,206952,"chrXIV"
"chrXIV","YNL238W (KEX2 QDS1 SRB1 VMA45)","+",205004,205169,204750,419,"W-open-W",204750,205169,"chrXIV"
"chrXIV","YNL239W (LAP3 BLH1 GAL6 YCP1)","+",202055,202212,201921,291,"W-open-W",201921,202212,"chrXIV"
"chrXIV","YNL240C (NAR1)","-",198390,NA,NA,NA,"+1_missing",198047,198411,"chrXIV"
"chrXIV","YNL241C (ZWF1 MET19 POS10)","-",196221,196047,196345,298,"W-open-W",196047,196345,"chrXIV"
"chrXIV","YNL242W (ATG2 APG2 AUT8 SPO72)","+",196150,196345,196047,298,"W-open-W",196047,196345,"chrXIV"
"chrXIV","YNL243W (SLA2 END4 MOP2)","+",191037,191228,190958,270,"W-open-W",190958,191228,"chrXIV"
"chrXIV","YNL244C (SUI1 MOF2 RFR1)","-",187036,186962,187145,183,"W-close-F",186962,187145,"chrXIV"
"chrXIV","YNL245C (CWC25)","-",185727,185668,185846,178,"W-close-W",185668,185846,"chrXIV"
"chrXIV","YNL246W (VPS75)","+",186627,186695,186525,170,"W-close-W",186525,186695,"chrXIV"
"chrXIV","YNL247W","+",185284,185485,185207,278,"W-open-W",185207,185485,"chrXIV"
"chrXIV","YNL248C (RPA49)","-",181160,181167,181386,219,"F-open-F",181167,181386,"chrXIV"
"chrXIV","YNL249C (MPA43)","-",179133,179064,179178,114,"F-overlap-F",179064,179178,"chrXIV"
"chrXIV","YNL251C (NRD1)","-",172450,172255,172524,269,"F-open-W",172255,172524,"chrXIV"
"chrXIV","YNL252C (MRPL17 MRPL30)","-",171312,171311,171480,169,"F-close-F",171311,171480,"chrXIV"
"chrXIV","YNL253W (TEX1)","+",171442,171480,171311,169,"F-close-F",171311,171480,"chrXIV"
"chrXIV","YNL254C (RTC4)","-",167815,167812,168091,279,"W-open-W",167812,168091,"chrXIV"
"chrXIV","YNL255C (GIS2)","-",167091,167007,167308,301,"F-open-W",167007,167308,"chrXIV"
"chrXIV","YNL256W (FOL1)","+",167157,167308,167007,301,"W-open-F",167007,167308,"chrXIV"
"chrXIV","YNL257C (SIP3)","-",160585,160390,160643,253,"W-open-W",160390,160643,"chrXIV"
"chrXIV","YNL258C (DSL1 RNS1)","-",158016,157857,158111,254,"W-open-W",157857,158111,"chrXIV"
"chrXIV","YNL259C (ATX1)","-",157534,157347,157589,242,"F-open-F",157347,157589,"chrXIV"
"chrXIV","YNL261W (ORC5)","+",156663,156650,156505,145,"W-close-F",156505,156650,"chrXIV"
"chrXIV","YNL262W (POL2 DUN2)","+",154923,155066,154776,290,"W-open-F",154776,155066,"chrXIV"
"chrXIV","YNL263C (YIF1)","-",146787,146568,146845,277,"F-open-W",146568,146845,"chrXIV"
"chrXIV","YNL264C (PDR17 ISS1 SFH4)","-",145421,145254,145521,267,"F-open-W",145254,145521,"chrXIV"
"chrXIV","YNL265C (IST1)","-",144125,144083,144171,88,"F-overlap-F",144083,144171,"chrXIV"
"chrXIV","YNL267W (PIK1 PIK120 PIK41)","+",144209,144263,144171,92,"F-overlap-W",144171,144263,"chrXIV"
"chrXIV","YNL268W (LYP1)","+",140534,140522,140345,177,"W-close-W",140345,140522,"chrXIV"
"chrXIV","YNL269W (BSC4)","+",138480,138491,138214,277,"W-open-W",138214,138491,"chrXIV"
"chrXIV","YNL270C (ALP1 APL1)","-",135846,135618,135911,293,"W-open-W",135618,135911,"chrXIV"
"chrXIV","YNL271C (BNI1 PPF3 SHE5)","-",129348,129148,129603,455,"W-open-W",129148,129603,"chrXIV"
"chrXIV","YNL272C (SEC2)","-",126693,126699,126865,166,"F-close-W",126699,126865,"chrXIV"
"chrXIV","YNL273W (TOF1)","+",126660,126699,126539,160,"F-close-W",126539,126699,"chrXIV"
"chrXIV","YNL274C (GOR1)","-",121007,120970,121042,72,"F-overlap-F",120970,121042,"chrXIV"
"chrXIV","YNL275W (BOR1)","+",121087,121195,121042,153,"F-close-F",121042,121195,"chrXIV"
"chrXIV","YNL276C","-",117063,116901,117199,298,"W-open-W",116901,117199,"chrXIV"
"chrXIV","YNL277W (MET2)","+",118929,119084,118707,377,"W-open-W",118707,119084,"chrXIV"
"chrXIV","YNL277W-A","+",117166,117199,116901,298,"W-open-W",116901,117199,"chrXIV"
"chrXIV","YNL278W (CAF120)","+",116642,116901,116515,386,"W-open-W",116515,116901,"chrXIV"
"chrXIV","YNL279W (PRM1)","+",113111,113134,112837,297,"W-open-W",112837,113134,"chrXIV"
"chrXIV","YNL280C (ERG24)","-",108990,108939,109134,195,"W-close-W",108939,109134,"chrXIV"
"chrXIV","YNL281W (HCH1)","+",109120,109134,108939,195,"W-close-W",108939,109134,"chrXIV"
"chrXIV","YNL282W (POP3)","+",108420,108459,108170,289,"W-open-W",108170,108459,"chrXIV"
"chrXIV","YNL283C (WSC2 STA3)","-",105033,104985,105207,222,"W-open-F",104985,105207,"chrXIV"
"chrXIV","YNL284C (MRPL10 MRPL18)","-",103046,103044,103204,160,"W-close-W",103044,103204,"chrXIV"
"chrXIV","YNL286W (CUS2)","+",96161,96287,96133,154,"W-close-F",96133,96287,"chrXIV"
"chrXIV","YNL287W (SEC21)","+",95033,95155,94917,238,"F-open-F",94917,95155,"chrXIV"
"chrXIV","YNL288W (CAF40)","+",91576,91836,91532,304,"W-open-W",91532,91836,"chrXIV"
"chrXIV","YNL289W (PCL1 HCS26)","+",88867,89077,88814,263,"W-open-F",88814,89077,"chrXIV"
"chrXIV","YNL290W (RFC3)","+",87321,87419,87216,203,"W-close-W",87216,87419,"chrXIV"
"chrXIV","YNL291C (MID1)","-",84049,83989,84188,199,"W-close-W",83989,84188,"chrXIV"
"chrXIV","YNL292W (PUS4)","+",84131,84188,83989,199,"W-close-W",83989,84188,"chrXIV"
"chrXIV","YNL293W (MSB3 GYP3)","+",82642,82831,82598,233,"W-open-W",82598,82831,"chrXIV"
"chrXIV","YNL294C (RIM21 PAL2)","-",78525,78468,78633,165,"F-close-F",78468,78633,"chrXIV"
"chrXIV","YNL295W","+",78657,78727,78633,94,"F-overlap-F",78633,78727,"chrXIV"
"chrXIV","YNL297C (MON2 YSL2)","-",71442,71388,71464,76,"F-overlap-F",71388,71464,"chrXIV"
"chrXIV","YNL298W (CLA4 ERC10)","+",71547,71620,71464,156,"F-close-F",71464,71620,"chrXIV"
"chrXIV","YNL299W (TRF5)","+",68509,68750,68414,336,"W-open-W",68414,68750,"chrXIV"
"chrXIV","YNL300W (TOS6)","+",66308,66493,66201,292,"W-open-W",66201,66493,"chrXIV"
"chrXIV","YNL301C (RPL18B RP28B)","-",63410,63128,63460,332,"W-open-F",63128,63460,"chrXIV"
"chrXIV","YNL302C (RPS19B RP55B)","-",61816,61754,62006,252,"F-open-F",61754,62006,"chrXIV"
"chrXIV","YNL304W (YPT11)","+",61647,61754,61576,178,"F-close-F",61576,61754,"chrXIV"
"chrXIV","YNL305C","-",58810,58790,58988,198,"W-close-W",58790,58988,"chrXIV"
"chrXIV","YNL306W (MRPS18)","+",58918,58988,58790,198,"W-close-W",58790,58988,"chrXIV"
"chrXIV","YNL307C (MCK1 CMS1 YPK1)","-",56111,55871,56163,292,"W-open-W",55871,56163,"chrXIV"
"chrXIV","YNL308C (KRI1)","-",53982,53995,54104,109,"F-overlap-F",53995,54104,"chrXIV"
"chrXIV","YNL309W (STB1)","+",54051,54104,53995,109,"F-overlap-F",53995,54104,"chrXIV"
"chrXIV","YNL310C (ZIM17 FMP28 HEP1 TIM15)","-",51818,51663,51941,278,"W-open-W",51663,51941,"chrXIV"
"chrXIV","YNL311C (SKP2)","-",49329,49303,49456,153,"W-close-W",49303,49456,"chrXIV"
"chrXIV","YNL312W (RFA2 BUF1 RPA2)","+",49300,49303,49126,177,"W-close-W",49126,49303,"chrXIV"
"chrXIV","YNL313C (EMW1)","-",45226,45153,45331,178,"F-close-W",45153,45331,"chrXIV"
"chrXIV","YNL314W (DAL82)","+",45313,45331,45153,178,"W-close-F",45153,45331,"chrXIV"
"chrXIV","YNL315C (ATP11)","-",43215,43076,43290,214,"W-close-W",43076,43290,"chrXIV"
"chrXIV","YNL316C (PHA2)","-",42021,41898,42128,230,"F-open-F",41898,42128,"chrXIV"
"chrXIV","YNL317W (PFS2)","+",42119,42128,41898,230,"F-open-F",41898,42128,"chrXIV"
"chrXIV","YNL318C (HXT14)","-",38349,38346,38492,146,"W-close-W",38346,38492,"chrXIV"
"chrXIV","YNL320W","+",38764,38853,38677,176,"W-close-F",38677,38853,"chrXIV"
"chrXIV","YNL321W (VNX1)","+",37552,37667,37404,263,"W-open-W",37404,37667,"chrXIV"
"chrXIV","YNL322C (KRE1)","-",33207,33061,33376,315,"W-open-F",33061,33376,"chrXIV"
"chrXIV","YNL323W (LEM3 BRE3 ROS3)","+",33306,33376,33061,315,"F-open-W",33061,33376,"chrXIV"
"chrXIV","YNL325C (FIG4)","-",28690,28564,28740,176,"W-close-W",28564,28740,"chrXIV"
"chrXIV","YNL326C (PFA3)","-",27201,27155,27340,185,"W-close-W",27155,27340,"chrXIV"
"chrXIV","YNL327W (EGT2)","+",27291,27340,27155,185,"W-close-W",27155,27340,"chrXIV"
"chrXIV","YNL328C (MDJ2)","-",22741,22632,22907,275,"W-open-W",22632,22907,"chrXIV"
"chrXIV","YNL329C (PEX6 PAS8)","-",19481,19293,19583,290,"W-open-W",19293,19583,"chrXIV"
"chrXIV","YNL330C (RPD3 MOF6 REC3 SDI2 SDS6)","-",17881,17737,17939,202,"W-close-F",17737,17939,"chrXIV"
"chrXIV","YNL331C (AAD14)","-",15904,NA,NA,NA,"+1_missing",14017,16007,"chrXIV"
"chrXIV","YNR001C (CIT1 CS1 LYS6)","-",629437,629419,629549,130,"F-close-W",629419,629549,"chrXIV"
"chrXIV","YNR001W-A","+",631806,631824,631535,289,"W-open-F",631535,631824,"chrXIV"
"chrXIV","YNR002C (ATO2 FUN34)","-",632860,632820,633008,188,"F-close-W",632820,633008,"chrXIV"
"chrXIV","YNR003C (RPC34)","-",634244,634039,634333,294,"W-open-W",634039,634333,"chrXIV"
"chrXIV","YNR004W (SWM2)","+",636779,636791,636718,73,"W-overlap-F",636718,636791,"chrXIV"
"chrXIV","YNR006W (VPS27 DID7 GRD11 SSV17 VPL23 VPT27)","+",638968,639023,638947,76,"F-overlap-F",638947,639023,"chrXIV"
"chrXIV","YNR007C (ATG3 APG3 AUT1)","-",638879,638772,638947,175,"F-close-W",638772,638947,"chrXIV"
"chrXIV","YNR008W (LRO1)","+",642626,642619,NA,NA,"-1_missing",642306,642619,"chrXIV"
"chrXIV","YNR009W (NRM1)","+",643602,643764,643496,268,"W-open-W",643496,643764,"chrXIV"
"chrXIV","YNR010W (CSE2 MED9)","+",644292,644301,644091,210,"W-close-W",644091,644301,"chrXIV"
"chrXIV","YNR011C (PRP2 RNA2)","-",644163,644091,644301,210,"W-close-W",644091,644301,"chrXIV"
"chrXIV","YNR012W (URK1)","+",649016,649135,648961,174,"F-close-W",648961,649135,"chrXIV"
"chrXIV","YNR013C (PHO91)","-",648926,648892,648961,69,"F-overlap-F",648892,648961,"chrXIV"
"chrXIV","YNR014W","+",653272,653442,653151,291,"W-open-W",653151,653442,"chrXIV"
"chrXIV","YNR015W (SMM1 DUS2)","+",654641,654787,654522,265,"F-open-F",654522,654787,"chrXIV"
"chrXIV","YNR016C (ACC1 ABP2 FAS3 MTR7)","-",654568,654522,654787,265,"F-open-F",654522,654787,"chrXIV"
"chrXIV","YNR017W (TIM23 MAS6 MIM23 MPI3)","+",663761,663803,663562,241,"W-open-W",663562,663803,"chrXIV"
"chrXIV","YNR018W (AIM38)","+",665070,665359,665000,359,"F-open-W",665000,665359,"chrXIV"
"chrXIV","YNR019W (ARE2 SAT1)","+",667403,667445,667235,210,"W-close-W",667235,667445,"chrXIV"
"chrXIV","YNR020C (ATP23)","-",667351,667235,667445,210,"W-close-W",667235,667445,"chrXIV"
"chrXIV","YNR021W","+",669770,669829,669661,168,"W-close-W",669661,669829,"chrXIV"
"chrXIV","YNR022C (MRPL50)","-",669661,669661,669829,168,"W-close-W",669661,669829,"chrXIV"
"chrXIV","YNR023W (SNF12 SWP73)","+",672213,672194,672021,173,"W-close-W",672021,672194,"chrXIV"
"chrXIV","YNR024W (MPP6)","+",673075,673179,672963,216,"F-open-F",672963,673179,"chrXIV"
"chrXIV","YNR025C","-",672554,672445,672600,155,"W-close-W",672445,672600,"chrXIV"
"chrXIV","YNR026C (SEC12 SED2)","-",673081,672963,673179,216,"F-open-F",672963,673179,"chrXIV"
"chrXIV","YNR027W (BUD17)","+",676137,676160,NA,NA,"-1_missing",675797,676160,"chrXIV"
"chrXIV","YNR028W (CPR8)","+",677193,677174,677007,167,"W-close-W",677007,677174,"chrXIV"
"chrXIV","YNR029C","-",677111,677007,677174,167,"W-close-W",677007,677174,"chrXIV"
"chrXIV","YNR030W (ALG12 ECM39)","+",680594,680712,680534,178,"F-close-F",680534,680712,"chrXIV"
"chrXIV","YNR031C (SSK2)","-",680593,680534,680712,178,"F-close-F",680534,680712,"chrXIV"
"chrXIV","YNR032C-A (HUB1)","-",687102,687087,687290,203,"W-close-W",687087,687290,"chrXIV"
"chrXIV","YNR032W (PPG1)","+",687237,687290,687087,203,"W-close-W",687087,687290,"chrXIV"
"chrXIV","YNR033W (ABZ1)","+",690063,690255,689941,314,"W-open-W",689941,690255,"chrXIV"
"chrXIV","YNR034W (SOL1)","+",691548,691597,691521,76,"F-overlap-F",691521,691597,"chrXIV"
"chrXIV","YNR034W-A","+",692960,693065,692801,264,"F-open-W",692801,693065,"chrXIV"
"chrXIV","YNR035C (ARC35 END9)","-",692974,692801,693065,264,"W-open-F",692801,693065,"chrXIV"
"chrXIV","YNR036C (MRPS12)","-",694198,694031,694326,295,"F-open-W",694031,694326,"chrXIV"
"chrXIV","YNR037C (RSM19)","-",694919,694772,695051,279,"W-open-W",694772,695051,"chrXIV"
"chrXIV","YNR038W (DBP6)","+",697626,697619,697440,179,"F-close-F",697440,697619,"chrXIV"
"chrXIV","YNR039C (ZRG17)","-",697557,697440,697619,179,"F-close-F",697440,697619,"chrXIV"
"chrXIV","YNR040W","+",700525,700596,700406,190,"W-close-W",700406,700596,"chrXIV"
"chrXIV","YNR041C (COQ2)","-",700499,700406,700596,190,"W-close-W",700406,700596,"chrXIV"
"chrXIV","YNR043W (MVD1 ERG19)","+",703232,703361,703198,163,"W-close-W",703198,703361,"chrXIV"
"chrXIV","YNR044W (AGA1)","+",705945,706152,705905,247,"W-open-W",705905,706152,"chrXIV"
"chrXIV","YNR045W (PET494)","+",707657,707793,707527,266,"W-open-W",707527,707793,"chrXIV"
"chrXIV","YNR046W (TRM112)","+",708331,708519,708267,252,"W-open-W",708267,708519,"chrXIV"
"chrXIV","YNR047W (FPK1)","+",711439,711657,711397,260,"W-open-W",711397,711657,"chrXIV"
"chrXIV","YNR048W (CRF1)","+",712999,712982,712793,189,"W-close-F",712793,712982,"chrXIV"
"chrXIV","YNR049C (MSO1)","-",712928,712793,712982,189,"F-close-W",712793,712982,"chrXIV"
"chrXIV","YNR050C (LYS9 LYS13)","-",713952,713899,714087,188,"W-close-F",713899,714087,"chrXIV"
"chrXIV","YNR051C (BRE5)","-",716343,716281,716439,158,"F-close-W",716281,716439,"chrXIV"
"chrXIV","YNR052C (POP2 CAF1)","-",719289,719258,719436,178,"W-close-W",719258,719436,"chrXIV"
"chrXIV","YNR053C (NOG2 NUG2)","-",720930,720711,720985,274,"F-open-W",720711,720985,"chrXIV"
"chrXIV","YNR054C (ESF2 ABT1)","-",723312,723119,723439,320,"W-open-W",723119,723439,"chrXIV"
"chrXIV","YNR055C (HOL1)","-",728342,728251,728395,144,"F-close-F",728251,728395,"chrXIV"
"chrXIV","YNR057C (BIO4)","-",733266,733247,733438,191,"F-close-F",733247,733438,"chrXIV"
"chrXIV","YNR058W (BIO3)","+",735763,735955,735739,216,"W-open-W",735739,735955,"chrXIV"
"chrXIV","YNR059W (MNT4)","+",738641,738747,738620,127,"W-close-F",738620,738747,"chrXIV"
"chrXIV","YNR060W (FRE4)","+",742170,742153,741986,167,"W-close-W",741986,742153,"chrXIV"
"chrXIV","YNR061C","-",742562,742535,742712,177,"W-close-W",742535,742712,"chrXIV"
"chrXIV","YNR063W","+",749767,749850,749709,141,"F-close-F",749709,749850,"chrXIV"
"chrXIV","YNR065C (YSN1)","-",750283,750233,750338,105,"F-overlap-F",750233,750338,"chrXIV"
"chrXIV","YNR067C (DSE4 ENG1)","-",755648,755565,755701,136,"F-close-W",755565,755701,"chrXIV"
"chrXIV","YNR068C","-",759807,759765,759940,175,"F-close-F",759765,759940,"chrXIV"
"chrXIV","YNR071C","-",770310,770292,770471,179,"W-close-W",770292,770471,"chrXIV"
"chrXIV","YNR072W (HXT17)","+",774479,774684,774450,234,"W-open-F",774450,774684,"chrXIV"
"chrXIV","YNR073C","-",774660,774450,774684,234,"F-open-W",774450,774684,"chrXIV"
"chrXIV","YNR074C (AIF1 CPD1)","-",777514,777484,777573,89,"F-overlap-F",777484,777573,"chrXIV"
"chrXV","YOL001W (PHO80 AGS3 TUP7 VAC5 phoR)","+",326268,NA,NA,NA,"+1_missing",326051,326854,"chrXV"
"chrXV","YOL002C (IZH2 PHO36)","-",323342,323222,323398,176,"W-close-W",323222,323398,"chrXV"
"chrXV","YOL003C (PFA4)","-",321733,321726,321934,208,"F-close-F",321726,321934,"chrXV"
"chrXV","YOL004W (SIN3 CPE1 GAM2 RPD1 SDI1 SDS16 UME4)","+",321667,321726,321580,146,"F-close-F",321580,321726,"chrXV"
"chrXV","YOL005C (RPB11)","-",315762,NA,NA,NA,"+1_missing",315455,315819,"chrXV"
"chrXV","YOL006C (TOP1 MAK1 MAK17)","-",312919,312878,313075,197,"W-close-W",312878,313075,"chrXV"
"chrXV","YOL007C (CSI2)","-",310982,310994,311128,134,"F-close-F",310994,311128,"chrXV"
"chrXV","YOL008W (COQ10)","+",311088,311128,310994,134,"F-close-F",310994,311128,"chrXV"
"chrXV","YOL009C (MDM12)","-",309265,NA,NA,NA,"+1_missing",308915,309319,"chrXV"
"chrXV","YOL010W (RCL1)","+",309143,309319,308915,404,"W-open-F",308915,309319,"chrXV"
"chrXV","YOL011W (PLB3)","+",307687,NA,NA,NA,"+1_missing",307636,308084,"chrXV"
"chrXV","YOL012C (HTZ1 HTA3)","-",303419,303397,303590,193,"W-close-F",303397,303590,"chrXV"
"chrXV","YOL013C (HRD1 DER3)","-",301326,NA,NA,NA,"+1_missing",300980,301485,"chrXV"
"chrXV","YOL013W-A (YOL013W-B)","+",301321,301485,NA,NA,"-1_missing",300980,301485,"chrXV"
"chrXV","YOL014W","+",300284,300331,300241,90,"F-overlap-W",300241,300331,"chrXV"
"chrXV","YOL015W (IRC10)","+",298975,299017,298837,180,"W-close-W",298837,299017,"chrXV"
"chrXV","YOL016C (CMK2)","-",294677,294657,294734,77,"F-overlap-W",294657,294734,"chrXV"
"chrXV","YOL017W (ESC8)","+",294787,294850,294734,116,"F-overlap-F",294734,294850,"chrXV"
"chrXV","YOL018C (TLG2)","-",290699,290634,NA,NA,"-1_missing",290634,291078,"chrXV"
"chrXV","YOL019W (TOS7)","+",290774,NA,NA,NA,"+1_missing",290634,291078,"chrXV"
"chrXV","YOL020W (TAT2 LTG3 SAB2 SCM2 TAP2)","+",288064,288157,287986,171,"F-close-F",287986,288157,"chrXV"
"chrXV","YOL021C (DIS3 RRP44)","-",282323,282028,282361,333,"W-open-W",282028,282361,"chrXV"
"chrXV","YOL022C (TSR4)","-",280168,280119,280261,142,"F-close-F",280119,280261,"chrXV"
"chrXV","YOL023W (IFM1)","+",280257,280261,280119,142,"F-close-F",280119,280261,"chrXV"
"chrXV","YOL024W","+",277638,277796,277562,234,"W-open-W",277562,277796,"chrXV"
"chrXV","YOL025W (LAG2 ECM36)","+",277015,277053,276890,163,"W-close-W",276890,277053,"chrXV"
"chrXV","YOL026C (MIM1 TOM13)","-",273908,273726,274005,279,"W-open-W",273726,274005,"chrXV"
"chrXV","YOL027C (MDM38 MKH1)","-",271810,271552,271836,284,"F-open-W",271552,271836,"chrXV"
"chrXV","YOL028C (YAP7)","-",270150,270097,270250,153,"W-close-W",270097,270250,"chrXV"
"chrXV","YOL029C","-",269806,269561,269915,354,"F-open-F",269561,269915,"chrXV"
"chrXV","YOL030W (GAS5)","+",269807,269915,269561,354,"F-open-F",269561,269915,"chrXV"
"chrXV","YOL031C (SIL1 SLS1)","-",266148,266075,266363,288,"F-open-F",266075,266363,"chrXV"
"chrXV","YOL032W (OPI10)","+",266217,266363,266075,288,"F-open-F",266075,266363,"chrXV"
"chrXV","YOL033W (MSE1)","+",265233,265385,265112,273,"F-open-F",265112,265385,"chrXV"
"chrXV","YOL034W (SMC5)","+",263282,263470,263255,215,"W-close-W",263255,263470,"chrXV"
"chrXV","YOL036W","+",259172,259392,259147,245,"F-open-W",259147,259392,"chrXV"
"chrXV","YOL037C","-",256626,256563,256764,201,"F-close-F",256563,256764,"chrXV"
"chrXV","YOL038C-A","-",254727,254734,254889,155,"W-close-F",254734,254889,"chrXV"
"chrXV","YOL038W (PRE6)","+",256171,256404,256076,328,"W-open-W",256076,256404,"chrXV"
"chrXV","YOL039W (RPP2A RPL44 RPLA2)","+",254816,254889,254734,155,"F-close-W",254734,254889,"chrXV"
"chrXV","YOL040C (RPS15 RPS21)","-",253034,252927,253132,205,"W-close-W",252927,253132,"chrXV"
"chrXV","YOL041C (NOP12)","-",251124,251020,251234,214,"W-close-F",251020,251234,"chrXV"
"chrXV","YOL042W (NGL1)","+",251184,251234,251020,214,"F-close-W",251020,251234,"chrXV"
"chrXV","YOL043C (NTG2 SCR2)","-",248294,248275,248450,175,"W-close-W",248275,248450,"chrXV"
"chrXV","YOL044W (PEX15 PAS21)","+",248374,248450,248275,175,"W-close-W",248275,248450,"chrXV"
"chrXV","YOL045W (PSK2)","+",246931,247140,246895,245,"F-open-W",246895,247140,"chrXV"
"chrXV","YOL047C","-",241397,241346,241580,234,"F-open-W",241346,241580,"chrXV"
"chrXV","YOL048C (RRT8)","-",240128,240121,240265,144,"F-close-F",240121,240265,"chrXV"
"chrXV","YOL049W (GSH2)","+",240205,240265,240121,144,"F-close-F",240121,240265,"chrXV"
"chrXV","YOL051W (GAL11 ABE1 MED15 RAR3 SDS4 SPT13)","+",238413,238450,238375,75,"F-overlap-F",238375,238450,"chrXV"
"chrXV","YOL052C (SPE2)","-",232315,NA,NA,NA,"+1_missing",231988,232450,"chrXV"
"chrXV","YOL052C-A (DDR2 DDRA2 YOL053C-A)","-",231294,231250,231471,221,"F-open-F",231250,231471,"chrXV"
"chrXV","YOL054W (PSH1)","+",229973,229996,229808,188,"W-close-F",229808,229996,"chrXV"
"chrXV","YOL055C (THI20)","-",224344,224245,224464,219,"W-open-F",224245,224464,"chrXV"
"chrXV","YOL056W (GPM3)","+",224349,224464,224245,219,"F-open-W",224245,224464,"chrXV"
"chrXV","YOL057W","+",223049,223238,222993,245,"W-open-W",222993,223238,"chrXV"
"chrXV","YOL058W (ARG1 ARG10)","+",220614,220802,220517,285,"W-open-W",220517,220802,"chrXV"
"chrXV","YOL059W (GPD2 GPD3)","+",218695,218707,218462,245,"F-open-W",218462,218707,"chrXV"
"chrXV","YOL060C (MAM3)","-",213736,213680,NA,NA,"-1_missing",213680,214046,"chrXV"
"chrXV","YOL061W (PRS5)","+",213870,214046,213680,366,"F-open-F",213680,214046,"chrXV"
"chrXV","YOL062C (APM4 AMP1)","-",210450,210275,210516,241,"W-open-W",210275,210516,"chrXV"
"chrXV","YOL063C (CRT10 HUS1)","-",207342,207182,207446,264,"W-open-W",207182,207446,"chrXV"
"chrXV","YOL064C (MET22 HAL2)","-",205996,205861,206077,216,"F-open-W",205861,206077,"chrXV"
"chrXV","YOL065C (INP54)","-",204665,204489,204711,222,"W-open-W",204489,204711,"chrXV"
"chrXV","YOL066C (RIB2 PUS8)","-",202632,202497,202753,256,"W-open-W",202497,202753,"chrXV"
"chrXV","YOL067C (RTG1)","-",201894,201777,202048,271,"W-open-W",201777,202048,"chrXV"
"chrXV","YOL068C (HST1)","-",200363,200259,200510,251,"F-open-F",200259,200510,"chrXV"
"chrXV","YOL069W (NUF2)","+",200451,200510,200259,251,"F-open-F",200259,200510,"chrXV"
"chrXV","YOL070C (NBA1)","-",197056,196887,197266,379,"W-open-W",196887,197266,"chrXV"
"chrXV","YOL071W (EMI5 SDH5)","+",197128,197266,196887,379,"W-open-W",196887,197266,"chrXV"
"chrXV","YOL072W (THP1 BUD29)","+",196454,196541,196330,211,"W-close-W",196330,196541,"chrXV"
"chrXV","YOL073C","-",193781,193578,193807,229,"W-open-W",193578,193807,"chrXV"
"chrXV","YOL075C","-",189359,189281,189383,102,"F-overlap-F",189281,189383,"chrXV"
"chrXV","YOL076W (MDM20 DEC1 NAA25)","+",189552,189633,189491,142,"F-close-F",189491,189633,"chrXV"
"chrXV","YOL077C (BRX1)","-",185772,185779,185956,177,"F-close-F",185779,185956,"chrXV"
"chrXV","YOL077W-A (ATP19)","+",185794,185779,185611,168,"W-close-F",185611,185779,"chrXV"
"chrXV","YOL078W (AVO1)","+",185291,185455,185159,296,"W-open-W",185159,185455,"chrXV"
"chrXV","YOL079W","+",181479,181705,181432,273,"W-open-W",181432,181705,"chrXV"
"chrXV","YOL080C (REX4)","-",180391,180321,180450,129,"F-close-F",180321,180450,"chrXV"
"chrXV","YOL081W (IRA2 CCS1 GLC4)","+",180483,180531,180450,81,"F-overlap-W",180450,180531,"chrXV"
"chrXV","YOL082W (ATG19 CVT19)","+",170071,170350,170041,309,"F-open-W",170041,170350,"chrXV"
"chrXV","YOL083W (ATG34 ATG19-B)","+",167044,167163,166897,266,"W-open-W",166897,167163,"chrXV"
"chrXV","YOL084W (PHM7)","+",165471,165583,165373,210,"F-close-F",165373,165583,"chrXV"
"chrXV","YOL085W-A","+",162306,162389,162259,130,"F-close-W",162259,162389,"chrXV"
"chrXV","YOL086C (ADH1 ADC1)","-",159459,159430,159647,217,"F-open-F",159430,159647,"chrXV"
"chrXV","YOL086W-A","+",159545,159647,159430,217,"F-open-F",159430,159647,"chrXV"
"chrXV","YOL087C","-",155177,155153,155342,189,"W-close-W",155153,155342,"chrXV"
"chrXV","YOL088C (MPD2)","-",153747,153511,153786,275,"F-open-W",153511,153786,"chrXV"
"chrXV","YOL089C (HAL9)","-",150226,150112,150250,138,"F-close-F",150112,150250,"chrXV"
"chrXV","YOL090W (MSH2 PMS5)","+",150358,150509,150250,259,"F-open-F",150250,150509,"chrXV"
"chrXV","YOL091W (SPO21 MPC70)","+",147236,147364,147118,246,"W-open-W",147118,147364,"chrXV"
"chrXV","YOL092W","+",145172,145324,145111,213,"F-close-W",145111,145324,"chrXV"
"chrXV","YOL093W (TRM10)","+",143802,143940,143767,173,"W-close-W",143767,143940,"chrXV"
"chrXV","YOL094C (RFC4)","-",141541,141520,141714,194,"W-close-W",141520,141714,"chrXV"
"chrXV","YOL095C (HMI1)","-",139162,139027,139254,227,"W-open-W",139027,139254,"chrXV"
"chrXV","YOL096C (COQ3)","-",137991,137783,138041,258,"W-open-W",137783,138041,"chrXV"
"chrXV","YOL097C (WRS1 HRE342)","-",136428,136269,136470,201,"W-close-W",136269,136470,"chrXV"
"chrXV","YOL097W-A","+",136529,136633,136470,163,"W-close-W",136470,136633,"chrXV"
"chrXV","YOL098C","-",132498,132393,132592,199,"F-close-F",132393,132592,"chrXV"
"chrXV","YOL100W (PKH2)","+",132586,132592,132393,199,"F-close-F",132393,132592,"chrXV"
"chrXV","YOL101C (IZH4)","-",126889,126899,127101,202,"F-close-W",126899,127101,"chrXV"
"chrXV","YOL102C (TPT1)","-",125893,125771,125958,187,"F-close-F",125771,125958,"chrXV"
"chrXV","YOL103W (ITR2 HRB612)","+",125992,126131,125958,173,"F-close-W",125958,126131,"chrXV"
"chrXV","YOL104C (NDJ1 TAM1)","-",116297,116038,116387,349,"W-open-W",116038,116387,"chrXV"
"chrXV","YOL105C (WSC3)","-",114006,113984,114066,82,"W-overlap-F",113984,114066,"chrXV"
"chrXV","YOL107W","+",113181,113213,113143,70,"W-overlap-F",113143,113213,"chrXV"
"chrXV","YOL108C (INO4)","-",111209,111172,111341,169,"W-close-W",111172,111341,"chrXV"
"chrXV","YOL109W (ZEO1)","+",110780,NA,NA,NA,"+1_missing",110595,111172,"chrXV"
"chrXV","YOL110W (SHR5 ERF4)","+",110040,110070,NA,NA,"-1_missing",109390,110070,"chrXV"
"chrXV","YOL111C (MDY2 GET5 TMA24)","-",108187,108073,108248,175,"W-close-W",108073,108248,"chrXV"
"chrXV","YOL112W (MSB4)","+",108267,108248,108073,175,"W-close-W",108073,108248,"chrXV"
"chrXV","YOL113W (SKM1)","+",106386,106596,106315,281,"F-open-W",106315,106596,"chrXV"
"chrXV","YOL114C","-",103276,103247,103415,168,"F-close-F",103247,103415,"chrXV"
"chrXV","YOL115W (PAP2 TRF4)","+",103342,103415,103247,168,"F-close-F",103247,103415,"chrXV"
"chrXV","YOL116W (MSN1 FUP1 HRB382 MSS10 PHD2)","+",101189,101215,101025,190,"W-close-W",101025,101215,"chrXV"
"chrXV","YOL117W (RRI2 CSN10)","+",99593,99721,99442,279,"W-open-W",99442,99721,"chrXV"
"chrXV","YOL119C (MCH4)","-",94709,NA,NA,NA,"+1_missing",94402,94829,"chrXV"
"chrXV","YOL120C (RPL18A RP28A)","-",93302,93262,93440,178,"F-close-W",93262,93440,"chrXV"
"chrXV","YOL121C (RPS19A)","-",91947,91893,92104,211,"F-close-W",91893,92104,"chrXV"
"chrXV","YOL122C (SMF1 SBS1)","-",89563,89528,89715,187,"F-close-F",89528,89715,"chrXV"
"chrXV","YOL123W (HRP1 NAB4 NAB5)","+",89587,89715,89528,187,"F-close-F",89528,89715,"chrXV"
"chrXV","YOL124C (TRM11)","-",85361,85180,85470,290,"W-open-W",85180,85470,"chrXV"
"chrXV","YOL125W (TRM13)","+",85296,85470,85180,290,"W-open-W",85180,85470,"chrXV"
"chrXV","YOL126C (MDH2)","-",81548,81488,81659,171,"F-close-W",81488,81659,"chrXV"
"chrXV","YOL127W (RPL25)","+",81287,81337,81127,210,"W-close-W",81127,81337,"chrXV"
"chrXV","YOL128C (YGK3)","-",78135,78091,78185,94,"F-overlap-W",78091,78185,"chrXV"
"chrXV","YOL129W (VPS68)","+",78257,78258,78185,73,"F-overlap-F",78185,78258,"chrXV"
"chrXV","YOL130W (ALR1 SWC3)","+",77339,77578,77285,293,"W-open-W",77285,77578,"chrXV"
"chrXV","YOL131W","+",73578,73561,73493,68,"F-overlap-W",73493,73561,"chrXV"
"chrXV","YOL132W (GAS4)","+",72776,72813,72591,222,"W-open-W",72591,72813,"chrXV"
"chrXV","YOL133W (HRT1 HRT2 RBX1 ROC1)","+",71001,71084,70945,139,"F-close-W",70945,71084,"chrXV"
"chrXV","YOL135C (MED7)","-",69257,68983,69430,447,"W-open-W",68983,69430,"chrXV"
"chrXV","YOL136C (PFK27)","-",67227,67242,67322,80,"F-overlap-F",67242,67322,"chrXV"
"chrXV","YOL137W (BSC6)","+",67363,67411,67322,89,"F-overlap-F",67322,67411,"chrXV"
"chrXV","YOL138C (RTC1)","-",61277,61071,61384,313,"W-open-W",61071,61384,"chrXV"
"chrXV","YOL139C (CDC33 TIF45)","-",60263,60156,60427,271,"W-open-W",60156,60427,"chrXV"
"chrXV","YOL140W (ARG8)","+",60117,60156,59942,214,"F-close-W",59942,60156,"chrXV"
"chrXV","YOL142W (RRP40)","+",56350,56490,56226,264,"W-open-W",56226,56490,"chrXV"
"chrXV","YOL143C (RIB4)","-",54522,54425,54584,159,"F-close-F",54425,54584,"chrXV"
"chrXV","YOL144W (NOP8)","+",54613,54661,54584,77,"F-overlap-F",54584,54661,"chrXV"
"chrXV","YOL145C (CTR9 CDP1)","-",49440,49403,49596,193,"W-close-W",49403,49596,"chrXV"
"chrXV","YOL146W (PSF3)","+",49514,49596,49403,193,"W-close-W",49403,49596,"chrXV"
"chrXV","YOL147C (PEX11 PMP24 PMP27)","-",47787,47588,47819,231,"F-open-W",47588,47819,"chrXV"
"chrXV","YOL148C (SPT20 ADA5)","-",45739,45616,45824,208,"W-close-F",45616,45824,"chrXV"
"chrXV","YOL149W (DCP1)","+",45698,45824,45616,208,"F-close-W",45616,45824,"chrXV"
"chrXV","YOL150C","-",43558,43360,43687,327,"W-open-W",43360,43687,"chrXV"
"chrXV","YOL151W (GRE2)","+",44791,44966,44719,247,"F-open-W",44719,44966,"chrXV"
"chrXV","YOL152W (FRE7)","+",42733,42760,42587,173,"W-close-F",42587,42760,"chrXV"
"chrXV","YOL154W (ZPS1)","+",35499,35620,35432,188,"W-close-W",35432,35620,"chrXV"
"chrXV","YOL155C (HPF1)","-",28589,28567,28803,236,"W-open-F",28567,28803,"chrXV"
"chrXV","YOL155W-A","+",27372,27527,27234,293,"W-open-F",27234,27527,"chrXV"
"chrXV","YOL157C (IMA2)","-",22381,22337,22634,297,"F-open-W",22337,22634,"chrXV"
"chrXV","YOL158C (ENB1 ARN4)","-",19339,19283,19479,196,"W-close-W",19283,19479,"chrXV"
"chrXV","YOL159C","-",17212,17114,17319,205,"W-close-W",17114,17319,"chrXV"
"chrXV","YOL159C-A","-",14702,14599,14823,224,"F-open-F",14599,14823,"chrXV"
"chrXV","YOL160W","+",14731,14823,14599,224,"F-open-F",14599,14823,"chrXV"
"chrXV","YOL163W","+",10478,10550,10393,157,"F-close-W",10393,10550,"chrXV"
"chrXV","YOL164W (BDS1)","+",8226,8271,8090,181,"W-close-W",8090,8271,"chrXV"
"chrXV","YOL164W-A","+",4715,4829,4683,146,"W-close-W",4683,4829,"chrXV"
"chrXV","YOR001W (RRP6)","+",329109,329115,328960,155,"W-close-F",328960,329115,"chrXV"
"chrXV","YOR002W (ALG6)","+",331162,331225,331142,83,"W-overlap-F",331142,331225,"chrXV"
"chrXV","YOR003W (YSP3)","+",333073,333162,332986,176,"F-close-W",332986,333162,"chrXV"
"chrXV","YOR004W (UTP23)","+",334497,334549,334460,89,"F-overlap-W",334460,334549,"chrXV"
"chrXV","YOR005C (DNL4 LIG4)","-",334403,334373,334460,87,"F-overlap-F",334373,334460,"chrXV"
"chrXV","YOR006C (TSR3)","-",337592,337326,337623,297,"F-open-W",337326,337623,"chrXV"
"chrXV","YOR007C (SGT2)","-",338830,338628,338926,298,"F-open-W",338628,338926,"chrXV"
"chrXV","YOR008C (SLG1 HCS77 WSC1)","-",340965,340679,341063,384,"F-open-F",340679,341063,"chrXV"
"chrXV","YOR010C (TIR2 SRP2)","-",346103,346107,346259,152,"W-close-F",346107,346259,"chrXV"
"chrXV","YOR011W (AUS1)","+",353950,354088,353895,193,"F-close-F",353895,354088,"chrXV"
"chrXV","YOR012W","+",357289,357461,357165,296,"W-open-W",357165,357461,"chrXV"
"chrXV","YOR013W (IRC11)","+",357290,357461,357165,296,"W-open-W",357165,357461,"chrXV"
"chrXV","YOR014W (RTS1 SCS1)","+",360178,360205,360099,106,"F-overlap-F",360099,360205,"chrXV"
"chrXV","YOR015W","+",360400,360452,360205,247,"F-open-W",360205,360452,"chrXV"
"chrXV","YOR016C (ERP4)","-",360304,360205,360452,247,"W-open-F",360205,360452,"chrXV"
"chrXV","YOR017W (PET127)","+",363970,364101,363936,165,"F-close-W",363936,364101,"chrXV"
"chrXV","YOR018W (ROD1 ART4)","+",367033,367054,366886,168,"F-close-F",366886,367054,"chrXV"
"chrXV","YOR019W","+",370511,370521,370357,164,"W-close-W",370357,370521,"chrXV"
"chrXV","YOR020C (HSP10 CPN10)","-",370423,370357,370521,164,"W-close-W",370357,370521,"chrXV"
"chrXV","YOR020W-A","+",372128,372207,372015,192,"W-close-W",372015,372207,"chrXV"
"chrXV","YOR021C","-",372645,372580,372665,85,"F-overlap-W",372580,372665,"chrXV"
"chrXV","YOR022C","-",373694,373449,373741,292,"W-open-W",373449,373741,"chrXV"
"chrXV","YOR023C (AHC1)","-",375959,375805,376013,208,"F-close-W",375805,376013,"chrXV"
"chrXV","YOR025W (HST3)","+",379712,379836,379560,276,"W-open-W",379560,379836,"chrXV"
"chrXV","YOR026W (BUB3)","+",380994,381033,NA,NA,"-1_missing",380694,381033,"chrXV"
"chrXV","YOR027W (STI1)","+",382931,383141,382830,311,"W-open-F",382830,383141,"chrXV"
"chrXV","YOR028C (CIN5 HAL6 YAP4)","-",383208,383141,383452,311,"F-open-F",383141,383452,"chrXV"
"chrXV","YOR030W (DFG16 ECM41 ZRG12)","+",388801,388896,388716,180,"F-close-W",388716,388896,"chrXV"
"chrXV","YOR031W (CRS5)","+",389532,389574,389307,267,"F-open-F",389307,389574,"chrXV"
"chrXV","YOR032C (HMS1)","-",389660,389679,389792,113,"F-overlap-F",389679,389792,"chrXV"
"chrXV","YOR032W-A","+",392901,392897,392701,196,"F-close-F",392701,392897,"chrXV"
"chrXV","YOR033C (EXO1 DHS1)","-",392358,392338,392413,75,"F-overlap-W",392338,392413,"chrXV"
"chrXV","YOR034C (AKR2)","-",394732,394632,394900,268,"W-open-W",394632,394900,"chrXV"
"chrXV","YOR035C (SHE4 DIM1)","-",397580,397587,397781,194,"F-close-F",397587,397781,"chrXV"
"chrXV","YOR036W (PEP12 VPL6 VPS6 VPT13)","+",401283,401363,401166,197,"W-close-W",401166,401363,"chrXV"
"chrXV","YOR037W (CYC2)","+",402757,402880,402616,264,"W-open-F",402616,402880,"chrXV"
"chrXV","YOR038C (HIR2 SPT1)","-",402665,402616,402880,264,"F-open-W",402616,402880,"chrXV"
"chrXV","YOR039W (CKB2)","+",406797,406828,406646,182,"W-close-W",406646,406828,"chrXV"
"chrXV","YOR040W (GLO4)","+",408207,408405,408110,295,"W-open-W",408110,408405,"chrXV"
"chrXV","YOR042W (CUE5)","+",409798,409940,409761,179,"W-close-W",409761,409940,"chrXV"
"chrXV","YOR043W (WHI2)","+",412486,412474,412287,187,"W-close-W",412287,412474,"chrXV"
"chrXV","YOR044W (IRC23)","+",413676,413866,413575,291,"W-open-W",413575,413866,"chrXV"
"chrXV","YOR045W (TOM6 ISP6 MOM8B)","+",414250,414358,414210,148,"W-close-F",414210,414358,"chrXV"
"chrXV","YOR046C (DBP5 RAT8)","-",414403,414358,414543,185,"W-close-F",414358,414543,"chrXV"
"chrXV","YOR047C (STD1 MSN3 SFS3)","-",416180,416152,416358,206,"W-close-F",416152,416358,"chrXV"
"chrXV","YOR048C (RAT1 HKE1 TAP1 XRN2)","-",418521,418390,418551,161,"F-close-F",418390,418551,"chrXV"
"chrXV","YOR049C (RSB1)","-",422467,422445,422637,192,"W-close-W",422445,422637,"chrXV"
"chrXV","YOR050C (YOR29-01)","-",424008,423899,424074,175,"W-close-W",423899,424074,"chrXV"
"chrXV","YOR051C (ETT1 YOR29-02)","-",424688,424654,424861,207,"F-close-F",424654,424861,"chrXV"
"chrXV","YOR052C (YOR29-03)","-",426505,426454,426533,79,"F-overlap-F",426454,426533,"chrXV"
"chrXV","YOR053W (YOR29-04)","+",428783,428781,428655,126,"F-close-F",428655,428781,"chrXV"
"chrXV","YOR054C (VHS3 YOR29-05)","-",427757,427637,427873,236,"F-open-W",427637,427873,"chrXV"
"chrXV","YOR056C (NOB1 YOR29-07)","-",430188,429971,430311,340,"W-open-F",429971,430311,"chrXV"
"chrXV","YOR057W (SGT1 YOR29-08)","+",433454,433502,433295,207,"W-close-W",433295,433502,"chrXV"
"chrXV","YOR058C (ASE1 YOR29-09)","-",433440,433295,433502,207,"W-close-W",433295,433502,"chrXV"
"chrXV","YOR059C (YOR29-10)","-",438851,NA,NA,NA,"+1_missing",438522,438903,"chrXV"
"chrXV","YOR060C (YOR29-11)","-",440311,440266,440481,215,"W-close-W",440266,440481,"chrXV"
"chrXV","YOR061W (CKA2 YOR29-12)","+",442764,442769,442569,200,"W-close-F",442569,442769,"chrXV"
"chrXV","YOR062C (YOR29-13)","-",442648,442569,442769,200,"F-close-W",442569,442769,"chrXV"
"chrXV","YOR063W (RPL3 MAK8 TCM1 YOR29-14)","+",445967,446053,445852,201,"F-close-F",445852,446053,"chrXV"
"chrXV","YOR064C (YNG1 YOR29-15)","-",445992,445852,446053,201,"F-close-F",445852,446053,"chrXV"
"chrXV","YOR065W (CYT1 CTC1 YOR29-16)","+",448670,448761,448555,206,"F-close-F",448555,448761,"chrXV"
"chrXV","YOR066W (MSA1 YOR29-17)","+",451541,451549,451453,96,"W-overlap-F",451453,451549,"chrXV"
"chrXV","YOR067C (ALG8 YOR29-18)","-",451644,451549,451753,204,"W-close-F",451549,451753,"chrXV"
"chrXV","YOR069W (VPS5 GRD2 PEP10 VPT5 YOR29-20)","+",455910,455966,455877,89,"F-overlap-W",455877,455966,"chrXV"
"chrXV","YOR070C (GYP1 YOR29-21)","-",455830,455706,455877,171,"F-close-F",455706,455877,"chrXV"
"chrXV","YOR071C (NRT1 THI71 YOR29-22)","-",459234,459227,459406,179,"F-close-F",459227,459406,"chrXV"
"chrXV","YOR073W (SGO1 YOR29-24)","+",466659,466658,466457,201,"W-close-F",466457,466658,"chrXV"
"chrXV","YOR074C (CDC21 CRT9 TMP1 YOR29-25)","-",466569,466457,466658,201,"F-close-W",466457,466658,"chrXV"
"chrXV","YOR075W (UFE1 YOR29-26)","+",469305,469349,469224,125,"W-close-F",469224,469349,"chrXV"
"chrXV","YOR076C (SKI7 YOR29-27)","-",469298,469224,469349,125,"F-close-W",469224,469349,"chrXV"
"chrXV","YOR077W (RTS2 YOR29-28)","+",472721,472727,NA,NA,"-1_missing",472344,472727,"chrXV"
"chrXV","YOR078W (BUD21 UTP16 YOR29-29)","+",473427,473577,473332,245,"F-open-F",473332,473577,"chrXV"
"chrXV","YOR079C (ATX2 YOR29-30)","-",473357,473332,473577,245,"F-open-F",473332,473577,"chrXV"
"chrXV","YOR080W (DIA2 YOR29-31)","+",476958,477031,476820,211,"F-close-F",476820,477031,"chrXV"
"chrXV","YOR081C (TGL5 STC2)","-",476848,476820,477031,211,"F-close-F",476820,477031,"chrXV"
"chrXV","YOR084W (LPX1)","+",481800,482023,481694,329,"W-open-W",481694,482023,"chrXV"
"chrXV","YOR085W (OST3)","+",483197,483242,483004,238,"F-open-F",483004,483242,"chrXV"
"chrXV","YOR086C (TCB1)","-",483107,483004,483242,238,"F-open-F",483004,483242,"chrXV"
"chrXV","YOR087W (YVC1 TRPY1 YOR088W)","+",489851,489931,489753,178,"F-close-F",489753,489931,"chrXV"
"chrXV","YOR089C (VPS21 VPS12 VPT12 YPT21 YPT51)","-",489999,490018,490195,177,"W-close-W",490018,490195,"chrXV"
"chrXV","YOR090C (PTC5 PPP1)","-",491040,490835,491160,325,"W-open-W",490835,491160,"chrXV"
"chrXV","YOR091W (TMA46 RBF46)","+",494534,494804,494413,391,"W-open-W",494413,494804,"chrXV"
"chrXV","YOR092W (ECM3 YOR3165W)","+",497160,497172,497030,142,"F-close-F",497030,497172,"chrXV"
"chrXV","YOR093C","-",497314,497172,497401,229,"F-open-F",497172,497401,"chrXV"
"chrXV","YOR094W (ARF3 ARL2)","+",503520,503580,503403,177,"F-close-W",503403,503580,"chrXV"
"chrXV","YOR095C (RKI1)","-",503407,503403,503580,177,"W-close-F",503403,503580,"chrXV"
"chrXV","YOR096W (RPS7A RPS30)","+",506857,506903,506699,204,"W-close-F",506699,506903,"chrXV"
"chrXV","YOR097C","-",506875,506699,506903,204,"F-close-W",506699,506903,"chrXV"
"chrXV","YOR098C (NUP1)","-",507815,507797,507974,177,"W-close-W",507797,507974,"chrXV"
"chrXV","YOR099W (KTR1)","+",513101,513203,512950,253,"F-open-W",512950,513203,"chrXV"
"chrXV","YOR100C (CRC1)","-",513036,512950,513203,253,"W-open-F",512950,513203,"chrXV"
"chrXV","YOR101W (RAS1)","+",516390,516490,516311,179,"F-close-W",516311,516490,"chrXV"
"chrXV","YOR102W","+",516857,516841,516677,164,"W-close-W",516677,516841,"chrXV"
"chrXV","YOR103C (OST2)","-",516358,516311,516490,179,"W-close-F",516311,516490,"chrXV"
"chrXV","YOR104W (PIN2)","+",518857,518848,518685,163,"W-close-W",518685,518848,"chrXV"
"chrXV","YOR106W (VAM3 PTH1)","+",520081,520073,519993,80,"F-overlap-F",519993,520073,"chrXV"
"chrXV","YOR107W (RGS2)","+",522616,522602,522427,175,"W-close-W",522427,522602,"chrXV"
"chrXV","YOR108W (LEU9)","+",524947,525172,524923,249,"F-open-W",524923,525172,"chrXV"
"chrXV","YOR109W (INP53 SJL3 SOP2)","+",528790,528898,528629,269,"W-open-W",528629,528898,"chrXV"
"chrXV","YOR110W (TFC7)","+",530311,530413,530254,159,"F-close-W",530254,530413,"chrXV"
"chrXV","YOR111W","+",531442,531490,531225,265,"W-open-W",531225,531490,"chrXV"
"chrXV","YOR112W (CEX1)","+",533856,534029,533758,271,"W-open-W",533758,534029,"chrXV"
"chrXV","YOR113W (AZF1)","+",537042,537160,536976,184,"W-close-W",536976,537160,"chrXV"
"chrXV","YOR114W","+",538660,538770,538610,160,"W-close-W",538610,538770,"chrXV"
"chrXV","YOR115C (TRS33)","-",538571,538521,538610,89,"W-overlap-F",538521,538610,"chrXV"
"chrXV","YOR116C (RPO31 RPC1 RPC160)","-",539661,539451,539720,269,"W-open-W",539451,539720,"chrXV"
"chrXV","YOR117W (RPT5 YTA1)","+",546474,546676,546442,234,"W-open-W",546442,546676,"chrXV"
"chrXV","YOR118W (RTC5)","+",548688,548765,548523,242,"F-open-W",548523,548765,"chrXV"
"chrXV","YOR119C (RIO1 RRP10)","-",548557,548523,548765,242,"W-open-F",548523,548765,"chrXV"
"chrXV","YOR120W (GCY1 GCY)","+",552191,552195,551960,235,"F-open-W",551960,552195,"chrXV"
"chrXV","YOR122C (PFY1 PRF1)","-",552119,551960,552195,235,"W-open-F",551960,552195,"chrXV"
"chrXV","YOR123C (LEO1)","-",553116,552846,553161,315,"W-open-W",552846,553161,"chrXV"
"chrXV","YOR124C (UBP2)","-",554745,554580,554857,277,"W-open-W",554580,554857,"chrXV"
"chrXV","YOR125C (CAT5 COQ7)","-",558892,558707,558963,256,"W-open-W",558707,558963,"chrXV"
"chrXV","YOR126C (IAH1)","-",559864,559753,559993,240,"W-open-W",559753,559993,"chrXV"
"chrXV","YOR127W (RGA1 DBM1 THE1)","+",564368,564595,564314,281,"W-open-F",564314,564595,"chrXV"
"chrXV","YOR128C (ADE2)","-",564412,564314,564595,281,"F-open-W",564314,564595,"chrXV"
"chrXV","YOR129C (AFI1)","-",566655,566468,566688,220,"W-open-F",566468,566688,"chrXV"
"chrXV","YOR130C (ORT1 ARG11)","-",569861,569862,570006,144,"W-close-F",569862,570006,"chrXV"
"chrXV","YOR131C","-",572109,NA,NA,NA,"+1_missing",571799,572366,"chrXV"
"chrXV","YOR132W (VPS17 PEP21 VPT3)","+",574880,575073,574764,309,"W-open-W",574764,575073,"chrXV"
"chrXV","YOR133W (EFT1)","+",577806,577984,577589,395,"W-open-W",577589,577984,"chrXV"
"chrXV","YOR134W (BAG7)","+",580156,580143,580071,72,"F-overlap-F",580071,580143,"chrXV"
"chrXV","YOR136W (IDH2)","+",581513,581568,581308,260,"F-open-F",581308,581568,"chrXV"
"chrXV","YOR137C (SIA1)","-",581685,581568,581823,255,"F-open-F",581568,581823,"chrXV"
"chrXV","YOR138C (RUP1)","-",584240,584030,584320,290,"W-open-W",584030,584320,"chrXV"
"chrXV","YOR140W (SFL1)","+",589722,589748,589602,146,"F-close-F",589602,589748,"chrXV"
"chrXV","YOR141C (ARP8)","-",589658,589602,589748,146,"F-close-F",589602,589748,"chrXV"
"chrXV","YOR142W (LSC1)","+",594257,594408,594189,219,"W-open-F",594189,594408,"chrXV"
"chrXV","YOR143C (THI80)","-",601214,601021,601283,262,"F-open-W",601021,601283,"chrXV"
"chrXV","YOR144C (ELG1 RTT110)","-",602578,602385,602650,265,"W-open-W",602385,602650,"chrXV"
"chrXV","YOR145C (PNO1 DIM2 RRP20)","-",605258,605108,605383,275,"W-open-W",605108,605383,"chrXV"
"chrXV","YOR146W","+",606338,606605,606175,430,"W-open-W",606175,606605,"chrXV"
"chrXV","YOR147W (MDM32)","+",608641,608641,608491,150,"F-close-W",608491,608641,"chrXV"
"chrXV","YOR148C (SPP2)","-",608556,608491,608641,150,"W-close-F",608491,608641,"chrXV"
"chrXV","YOR149C (SMP3 LAS2 SAP2)","-",609510,609453,609623,170,"W-close-W",609453,609623,"chrXV"
"chrXV","YOR150W (MRPL23)","+",612598,612699,612509,190,"F-close-F",612509,612699,"chrXV"
"chrXV","YOR151C (RPB2 RPB150 RPO22 SIT2 SOH2)","-",612658,612509,612699,190,"F-close-F",612509,612699,"chrXV"
"chrXV","YOR152C","-",617352,617198,617372,174,"F-close-W",617198,617372,"chrXV"
"chrXV","YOR153W (PDR5 LEM1 STS1 YDR1)","+",624493,624713,624401,312,"W-open-W",624401,624713,"chrXV"
"chrXV","YOR154W (SLP1)","+",626643,626681,626501,180,"W-close-F",626501,626681,"chrXV"
"chrXV","YOR155C (ISN1)","-",626519,626501,626681,180,"F-close-W",626501,626681,"chrXV"
"chrXV","YOR156C (NFI1 SIZ2)","-",628107,627955,628220,265,"W-open-W",627955,628220,"chrXV"
"chrXV","YOR157C (PUP1)","-",630894,630845,631035,190,"W-close-F",630845,631035,"chrXV"
"chrXV","YOR158W (PET123)","+",633197,633235,633105,130,"F-close-F",633105,633235,"chrXV"
"chrXV","YOR159C (SME1)","-",633049,633032,633105,73,"F-overlap-F",633032,633105,"chrXV"
"chrXV","YOR160W (MTR10 KAP111)","+",636843,636999,636778,221,"F-open-F",636778,636999,"chrXV"
"chrXV","YOR161C (PNS1)","-",636820,636778,636999,221,"F-open-F",636778,636999,"chrXV"
"chrXV","YOR161C-C","-",638723,638680,NA,NA,"-1_missing",638680,639180,"chrXV"
"chrXV","YOR162C (YRR1 PDR2)","-",639409,639180,639437,257,"F-open-W",639180,639437,"chrXV"
"chrXV","YOR163W (DDP1)","+",643380,643438,643293,145,"F-close-W",643293,643438,"chrXV"
"chrXV","YOR164C (GET4)","-",643188,643098,643220,122,"F-close-F",643098,643220,"chrXV"
"chrXV","YOR165W (SEY1)","+",647063,647132,NA,NA,"-1_missing",646751,647132,"chrXV"
"chrXV","YOR166C (SWT1)","-",646913,646751,647132,381,"F-open-F",646751,647132,"chrXV"
"chrXV","YOR167C (RPS28A RPS33A)","-",648673,648680,648844,164,"W-close-F",648680,648844,"chrXV"
"chrXV","YOR168W (GLN4)","+",651833,651889,651681,208,"F-close-F",651681,651889,"chrXV"
"chrXV","YOR171C (LCB4)","-",651989,651889,652070,181,"W-close-F",651889,652070,"chrXV"
"chrXV","YOR172W (YRM1)","+",656747,656836,656623,213,"W-close-F",656623,656836,"chrXV"
"chrXV","YOR173W (DCS2)","+",658457,658452,658287,165,"W-close-W",658287,658452,"chrXV"
"chrXV","YOR174W (MED4)","+",659726,659741,659613,128,"F-close-F",659613,659741,"chrXV"
"chrXV","YOR175C (ALE1 LCA1 LPT1 SLC4)","-",659653,659613,659741,128,"F-close-F",659613,659741,"chrXV"
"chrXV","YOR176W (HEM15)","+",663714,664012,663633,379,"F-open-F",663633,664012,"chrXV"
"chrXV","YOR177C (MPC54)","-",665344,665252,665391,139,"W-close-F",665252,665391,"chrXV"
"chrXV","YOR178C (GAC1)","-",667655,667673,667834,161,"F-close-F",667673,667834,"chrXV"
"chrXV","YOR179C (SYC1)","-",671586,671550,671713,163,"F-close-F",671550,671713,"chrXV"
"chrXV","YOR180C (DCI1 ECI2)","-",674094,NA,NA,NA,"+1_missing",673706,674115,"chrXV"
"chrXV","YOR181W (LAS17 BEE1)","+",677952,678018,677865,153,"F-close-F",677865,678018,"chrXV"
"chrXV","YOR182C (RPS30B)","-",678094,678018,678142,124,"F-close-F",678018,678142,"chrXV"
"chrXV","YOR184W (SER1 ADE9)","+",680646,680797,680591,206,"W-close-W",680591,680797,"chrXV"
"chrXV","YOR185C (GSP2 CNR2)","-",681378,681248,681496,248,"W-open-W",681248,681496,"chrXV"
"chrXV","YOR186C-A","-",682938,682880,683053,173,"F-close-F",682880,683053,"chrXV"
"chrXV","YOR186W","+",683669,683926,683606,320,"W-open-W",683606,683926,"chrXV"
"chrXV","YOR187W (TUF1 tufM)","+",685465,685480,685293,187,"W-close-W",685293,685480,"chrXV"
"chrXV","YOR188W (MSB1)","+",689310,689346,689165,181,"F-close-W",689165,689346,"chrXV"
"chrXV","YOR189W (IES4)","+",690197,690301,690130,171,"F-close-W",690130,690301,"chrXV"
"chrXV","YOR190W (SPR1 SSG1)","+",692182,692217,692142,75,"W-overlap-F",692142,692217,"chrXV"
"chrXV","YOR191W (ULS1 DIS1 RIS1 TID4)","+",697534,697645,697438,207,"F-close-F",697438,697645,"chrXV"
"chrXV","YOR192C (THI72)","-",698051,697996,698073,77,"W-overlap-F",697996,698073,"chrXV"
"chrXV","YOR193W (PEX27)","+",711690,711731,711548,183,"W-close-W",711548,711731,"chrXV"
"chrXV","YOR194C (TOA1)","-",711594,711548,711731,183,"W-close-W",711548,711731,"chrXV"
"chrXV","YOR195W (SLK19)","+",715549,715660,715502,158,"F-close-F",715502,715660,"chrXV"
"chrXV","YOR196C (LIP5)","-",715432,715251,715502,251,"F-open-F",715251,715502,"chrXV"
"chrXV","YOR197W (MCA1 YCA1)","+",718462,718489,718410,79,"F-overlap-F",718410,718489,"chrXV"
"chrXV","YOR198C (BFR1)","-",718429,718410,718489,79,"F-overlap-F",718410,718489,"chrXV"
"chrXV","YOR201C (MRM1 PET56)","-",720396,720237,720524,287,"W-open-W",720237,720524,"chrXV"
"chrXV","YOR202W (HIS3 HIS10 HIS8)","+",722617,NA,NA,NA,"+1_missing",721643,722951,"chrXV"
"chrXV","YOR204W (DED1 SPP81)","+",725446,725531,725382,149,"F-close-F",725382,725531,"chrXV"
"chrXV","YOR205C (GEP3 AIM40 FMP38 LRC5)","-",725443,725382,725531,149,"F-close-F",725382,725531,"chrXV"
"chrXV","YOR206W (NOC2)","+",729731,729788,729650,138,"F-close-F",729650,729788,"chrXV"
"chrXV","YOR207C (RET1 PDS2 RPC128 RPC2)","-",729879,729788,729938,150,"F-close-F",729788,729938,"chrXV"
"chrXV","YOR208W (PTP2)","+",736300,736290,736121,169,"F-close-F",736121,736290,"chrXV"
"chrXV","YOR209C (NPT1)","-",736306,736290,736411,121,"F-close-F",736290,736411,"chrXV"
"chrXV","YOR210W (RPB10)","+",738828,738822,738641,181,"W-close-W",738641,738822,"chrXV"
"chrXV","YOR211C (MGM1 MNA1)","-",738819,738822,739002,180,"W-close-W",738822,739002,"chrXV"
"chrXV","YOR212W (STE4 HMD2)","+",744303,744317,744240,77,"F-overlap-F",744240,744317,"chrXV"
"chrXV","YOR213C (SAS5)","-",744191,744129,744240,111,"F-overlap-F",744129,744240,"chrXV"
"chrXV","YOR214C","-",745512,745351,745617,266,"W-open-W",745351,745617,"chrXV"
"chrXV","YOR215C (AIM41)","-",746576,746460,746780,320,"W-open-F",746460,746780,"chrXV"
"chrXV","YOR216C (RUD3 GRP1)","-",747422,747257,747540,283,"W-open-W",747257,747540,"chrXV"
"chrXV","YOR217W (RFC1 CDC44)","+",752114,752177,752001,176,"W-close-W",752001,752177,"chrXV"
"chrXV","YOR219C (STE13 YCI1)","-",752059,752001,752177,176,"W-close-W",752001,752177,"chrXV"
"chrXV","YOR220W (RCN2 WSP1)","+",756297,756439,756159,280,"F-open-W",756159,756439,"chrXV"
"chrXV","YOR221C (MCT1)","-",756289,756159,756439,280,"W-open-F",756159,756439,"chrXV"
"chrXV","YOR222W (ODC2)","+",759313,759345,759181,164,"W-close-W",759181,759345,"chrXV"
"chrXV","YOR223W","+",760808,760789,760617,172,"W-close-W",760617,760789,"chrXV"
"chrXV","YOR224C (RPB8)","-",760696,760617,760789,172,"W-close-W",760617,760789,"chrXV"
"chrXV","YOR226C (ISU2 NUA2)","-",761457,761242,761585,343,"W-open-W",761242,761585,"chrXV"
"chrXV","YOR227W (HER1)","+",766726,766874,766679,195,"F-close-F",766679,766874,"chrXV"
"chrXV","YOR228C","-",766736,766679,766874,195,"F-close-F",766679,766874,"chrXV"
"chrXV","YOR229W (WTM2)","+",770017,770078,769840,238,"F-open-F",769840,770078,"chrXV"
"chrXV","YOR230W (WTM1)","+",772284,772498,772177,321,"F-open-W",772177,772498,"chrXV"
"chrXV","YOR231W (MKK1 SSP32)","+",774345,774494,774237,257,"W-open-W",774237,774494,"chrXV"
"chrXV","YOR232W (MGE1 GRPE YGE1)","+",775403,775445,775266,179,"W-close-W",775266,775445,"chrXV"
"chrXV","YOR233W (KIN4 KIN3 KIN31)","+",778315,778402,778230,172,"F-close-W",778230,778402,"chrXV"
"chrXV","YOR234C (RPL33B RPL37B)","-",778457,778402,778628,226,"W-open-W",778402,778628,"chrXV"
"chrXV","YOR236W (DFR1)","+",781607,781819,781477,342,"W-open-W",781477,781819,"chrXV"
"chrXV","YOR237W (HES1 OSH5)","+",783364,783502,783231,271,"F-open-W",783231,783502,"chrXV"
"chrXV","YOR238W","+",784668,784852,784599,253,"W-open-W",784599,784852,"chrXV"
"chrXV","YOR239W (ABP140 YOR240W)","+",786960,787171,786893,278,"W-open-W",786893,787171,"chrXV"
"chrXV","YOR241W (MET7 MET23)","+",788781,788797,788724,73,"F-overlap-F",788724,788797,"chrXV"
"chrXV","YOR242C (SSP2)","-",788629,788624,788724,100,"F-overlap-F",788624,788724,"chrXV"
"chrXV","YOR243C (PUS7)","-",789987,789816,790028,212,"W-close-W",789816,790028,"chrXV"
"chrXV","YOR244W (ESA1 TAS1)","+",793973,793982,793864,118,"F-overlap-W",793864,793982,"chrXV"
"chrXV","YOR245C (DGA1)","-",793961,793864,793982,118,"W-overlap-F",793864,793982,"chrXV"
"chrXV","YOR246C","-",795718,795715,795885,170,"W-close-F",795715,795885,"chrXV"
"chrXV","YOR247W (SRL1)","+",798504,798579,798374,205,"W-close-W",798374,798579,"chrXV"
"chrXV","YOR248W (TOS11)","+",798504,798579,798374,205,"W-close-W",798374,798579,"chrXV"
"chrXV","YOR249C (APC5 RMC1)","-",798605,798579,798742,163,"W-close-W",798579,798742,"chrXV"
"chrXV","YOR250C (CLP1)","-",800931,800939,801100,161,"W-close-W",800939,801100,"chrXV"
"chrXV","YOR251C (TUM1)","-",802459,802299,802533,234,"W-open-W",802299,802533,"chrXV"
"chrXV","YOR252W (TMA16 RBF17)","+",804304,804405,804174,231,"W-open-W",804174,804405,"chrXV"
"chrXV","YOR253W (NAT5 ARD2 NAA50 ROG2)","+",805023,805105,804915,190,"F-close-F",804915,805105,"chrXV"
"chrXV","YOR254C (SEC63 PTL1)","-",804939,804915,805105,190,"F-close-F",804915,805105,"chrXV"
"chrXV","YOR255W (OSW1)","+",808283,808343,808210,133,"F-close-W",808210,808343,"chrXV"
"chrXV","YOR256C (TRE2)","-",808176,808142,808210,68,"F-overlap-F",808142,808210,"chrXV"
"chrXV","YOR257W (CDC31 DSK1)","+",811548,811534,811356,178,"W-close-W",811356,811534,"chrXV"
"chrXV","YOR258W (HNT3)","+",812413,812473,812364,109,"W-overlap-F",812364,812473,"chrXV"
"chrXV","YOR259C (RPT4 CRL13 PCS1 SUG2)","-",812319,812213,812364,151,"W-close-W",812213,812364,"chrXV"
"chrXV","YOR260W (GCD1 TRA3)","+",815841,815826,815737,89,"F-overlap-F",815737,815826,"chrXV"
"chrXV","YOR261C (RPN8)","-",815832,815826,816007,181,"W-close-F",815826,816007,"chrXV"
"chrXV","YOR262W","+",818436,818472,818276,196,"W-close-W",818276,818472,"chrXV"
"chrXV","YOR264W (DSE3)","+",820261,820449,820230,219,"W-open-W",820230,820449,"chrXV"
"chrXV","YOR265W (RBL2)","+",820886,820981,820751,230,"W-open-W",820751,820981,"chrXV"
"chrXV","YOR266W (PNT1)","+",822369,822355,822277,78,"F-overlap-F",822277,822355,"chrXV"
"chrXV","YOR267C (HRK1)","-",822407,822355,822466,111,"F-overlap-F",822355,822466,"chrXV"
"chrXV","YOR268C","-",825316,825225,825451,226,"F-open-W",825225,825451,"chrXV"
"chrXV","YOR269W (PAC1)","+",828027,828101,827809,292,"F-open-F",827809,828101,"chrXV"
"chrXV","YOR270C (VPH1)","-",827925,827809,828101,292,"F-open-F",827809,828101,"chrXV"
"chrXV","YOR271C (FSF1)","-",830946,830703,831048,345,"F-open-W",830703,831048,"chrXV"
"chrXV","YOR272W (YTM1)","+",834274,834438,834243,195,"F-close-W",834243,834438,"chrXV"
"chrXV","YOR273C (TPO4)","-",834298,834243,834438,195,"W-close-F",834243,834438,"chrXV"
"chrXV","YOR274W (MOD5)","+",839206,839273,839176,97,"F-overlap-F",839176,839273,"chrXV"
"chrXV","YOR275C (RIM20)","-",838952,838917,839072,155,"F-close-F",838917,839072,"chrXV"
"chrXV","YOR276W (CAF20 CAF2 CAP20)","+",841922,841980,841811,169,"W-close-W",841811,841980,"chrXV"
"chrXV","YOR277C","-",841275,841064,841346,282,"W-open-W",841064,841346,"chrXV"
"chrXV","YOR278W (HEM4 SLU2)","+",843725,843769,843654,115,"F-overlap-F",843654,843769,"chrXV"
"chrXV","YOR279C (RFM1)","-",843604,843532,843654,122,"F-close-W",843532,843654,"chrXV"
"chrXV","YOR280C (FSH3)","-",844915,844716,844943,227,"W-open-W",844716,844943,"chrXV"
"chrXV","YOR281C (PLP2)","-",846175,846159,846331,172,"F-close-F",846159,846331,"chrXV"
"chrXV","YOR283W","+",848288,848488,848222,266,"W-open-W",848222,848488,"chrXV"
"chrXV","YOR284W (HUA2)","+",849490,849660,849376,284,"W-open-W",849376,849660,"chrXV"
"chrXV","YOR285W (RDL1)","+",850126,850304,850030,274,"F-open-W",850030,850304,"chrXV"
"chrXV","YOR286W (RDL2 AIM42 FMP31)","+",850813,850824,850661,163,"W-close-W",850661,850824,"chrXV"
"chrXV","YOR287C (RRP36)","-",850868,850824,850993,169,"W-close-W",850824,850993,"chrXV"
"chrXV","YOR288C (MPD1)","-",852037,851821,852103,282,"W-open-W",851821,852103,"chrXV"
"chrXV","YOR289W","+",854193,NA,NA,NA,"+1_missing",854074,854592,"chrXV"
"chrXV","YOR290C (SNF2 GAM1 HAF1 SWI2 TYE3)","-",855070,854923,855168,245,"F-open-F",854923,855168,"chrXV"
"chrXV","YOR291W (YPK9)","+",865664,865717,865506,211,"F-close-F",865506,865717,"chrXV"
"chrXV","YOR292C","-",865588,865506,865717,211,"F-close-F",865506,865717,"chrXV"
"chrXV","YOR293C-A","-",867915,867876,868058,182,"W-close-F",867876,868058,"chrXV"
"chrXV","YOR293W (RPS10A)","+",867993,868058,867876,182,"F-close-W",867876,868058,"chrXV"
"chrXV","YOR294W (RRS1)","+",869100,869196,868969,227,"W-open-F",868969,869196,"chrXV"
"chrXV","YOR295W (UAF30)","+",870125,870145,869899,246,"W-open-W",869899,870145,"chrXV"
"chrXV","YOR296W","+",874273,874505,874198,307,"W-open-W",874198,874505,"chrXV"
"chrXV","YOR297C (TIM18)","-",874614,874601,874831,230,"W-open-F",874601,874831,"chrXV"
"chrXV","YOR298C-A (MBF1 SUF13)","-",876999,876976,877237,261,"W-open-F",876976,877237,"chrXV"
"chrXV","YOR298W (MUM3)","+",877096,877237,876976,261,"F-open-W",876976,877237,"chrXV"
"chrXV","YOR301W (RAX1)","+",882582,882752,882530,222,"W-open-F",882530,882752,"chrXV"
"chrXV","YOR302W","+",883246,883262,883085,177,"W-close-W",883085,883262,"chrXV"
"chrXV","YOR303W (CPA1)","+",884209,884399,884145,254,"F-open-F",884145,884399,"chrXV"
"chrXV","YOR304C-A","-",888188,888039,888210,171,"W-close-W",888039,888210,"chrXV"
"chrXV","YOR304W (ISW2)","+",887959,888039,887869,170,"F-close-W",887869,888039,"chrXV"
"chrXV","YOR305W (RRG7)","+",889837,889863,889665,198,"W-close-W",889665,889863,"chrXV"
"chrXV","YOR306C (MCH5)","-",889805,889665,889863,198,"W-close-W",889665,889863,"chrXV"
"chrXV","YOR307C (SLY41)","-",892558,892505,892584,79,"F-overlap-F",892505,892584,"chrXV"
"chrXV","YOR308C (SNU66)","-",894425,894201,894509,308,"W-open-F",894201,894509,"chrXV"
"chrXV","YOR309C","-",896539,896374,896632,258,"F-open-W",896374,896632,"chrXV"
"chrXV","YOR310C (NOP58 NOP5)","-",896506,896374,896632,258,"F-open-W",896374,896632,"chrXV"
"chrXV","YOR311C (DGK1 HSD1)","-",898847,898808,898985,177,"W-close-W",898808,898985,"chrXV"
"chrXV","YOR312C (RPL20B RPL18A1)","-",900164,899926,900226,300,"W-open-W",899926,900226,"chrXV"
"chrXV","YOR313C (SPS4)","-",901647,NA,NA,NA,"+1_missing",901198,901872,"chrXV"
"chrXV","YOR314W-A","+",904674,904839,904642,197,"W-close-W",904642,904839,"chrXV"
"chrXV","YOR315W (SFG1)","+",906211,906325,906014,311,"F-open-F",906014,906325,"chrXV"
"chrXV","YOR316C (COT1)","-",906100,906014,906325,311,"F-open-F",906014,906325,"chrXV"
"chrXV","YOR317W (FAA1)","+",911689,911767,911553,214,"F-close-W",911553,911767,"chrXV"
"chrXV","YOR318C","-",911615,911553,911767,214,"W-close-F",911553,911767,"chrXV"
"chrXV","YOR319W (HSH49)","+",913614,913669,913481,188,"F-close-W",913481,913669,"chrXV"
"chrXV","YOR320C (GNT1)","-",913510,913481,913669,188,"W-close-F",913481,913669,"chrXV"
"chrXV","YOR321W (PMT3)","+",918327,918384,918290,94,"F-overlap-F",918290,918384,"chrXV"
"chrXV","YOR322C (LDB19 ART1)","-",918469,918384,918501,117,"F-overlap-F",918384,918501,"chrXV"
"chrXV","YOR323C (PRO2)","-",921434,921247,921529,282,"W-open-W",921247,921529,"chrXV"
"chrXV","YOR324C (FRT1 HPH1)","-",923097,923116,923317,201,"W-close-W",923116,923317,"chrXV"
"chrXV","YOR326W (MYO2 CDC66)","+",930572,930615,930310,305,"W-open-F",930310,930615,"chrXV"
"chrXV","YOR327C (SNC2)","-",930615,930615,930791,176,"W-close-F",930615,930791,"chrXV"
"chrXV","YOR328W (PDR10)","+",936572,936596,936517,79,"F-overlap-F",936517,936596,"chrXV"
"chrXV","YOR329C (SCD5 FTB1)","-",936631,936596,936726,130,"F-close-F",936596,936726,"chrXV"
"chrXV","YOR332W (VMA4)","+",944427,944606,944369,237,"W-open-W",944369,944606,"chrXV"
"chrXV","YOR333C (SWF5)","-",944498,944369,944606,237,"W-open-W",944369,944606,"chrXV"
"chrXV","YOR334W (MRS2)","+",946105,946160,945963,197,"F-close-F",945963,946160,"chrXV"
"chrXV","YOR335C (ALA1 CDC64)","-",946094,945963,946160,197,"F-close-F",945963,946160,"chrXV"
"chrXV","YOR336W (KRE5)","+",954011,954026,953847,179,"W-close-W",953847,954026,"chrXV"
"chrXV","YOR337W (TEA1)","+",956873,956857,NA,NA,"-1_missing",956547,956857,"chrXV"
"chrXV","YOR338W","+",958242,958383,958152,231,"F-open-F",958152,958383,"chrXV"
"chrXV","YOR339C (UBC11)","-",958111,958059,958152,93,"F-overlap-F",958059,958152,"chrXV"
"chrXV","YOR340C (RPA43)","-",959085,959061,959248,187,"W-close-W",959061,959248,"chrXV"
"chrXV","YOR341W (RPA190 RRN1)","+",966264,966308,966221,87,"F-overlap-F",966221,966308,"chrXV"
"chrXV","YOR342C","-",966511,966468,966654,186,"W-close-W",966468,966654,"chrXV"
"chrXV","YOR343C","-",967958,967934,NA,NA,"-1_missing",967934,968449,"chrXV"
"chrXV","YOR344C (TYE7 SGC1)","-",977042,977004,977201,197,"F-close-F",977004,977201,"chrXV"
"chrXV","YOR346W (REV1)","+",984866,985051,984791,260,"F-open-F",984791,985051,"chrXV"
"chrXV","YOR347C (PYK2)","-",984528,984484,984690,206,"F-close-F",984484,984690,"chrXV"
"chrXV","YOR348C (PUT4)","-",986731,986503,986783,280,"W-open-W",986503,986783,"chrXV"
"chrXV","YOR349W (CIN1)","+",992899,992937,992779,158,"F-close-F",992779,992937,"chrXV"
"chrXV","YOR350C (MNE1)","-",992795,992779,992937,158,"F-close-F",992779,992937,"chrXV"
"chrXV","YOR352W","+",998314,998361,998260,101,"F-overlap-W",998260,998361,"chrXV"
"chrXV","YOR353C (SOG2)","-",998442,998361,998520,159,"W-close-W",998361,998520,"chrXV"
"chrXV","YOR354C (MSC6)","-",1001031,1000825,1001121,296,"W-open-W",1000825,1001121,"chrXV"
"chrXV","YOR355W (GDS1)","+",1006893,1006943,1006866,77,"F-overlap-F",1006866,1006943,"chrXV"
"chrXV","YOR356W","+",1009230,1009274,1009035,239,"F-open-F",1009035,1009274,"chrXV"
"chrXV","YOR357C (SNX3 GRD19)","-",1009114,1009035,1009274,239,"F-open-F",1009035,1009274,"chrXV"
"chrXV","YOR358W (HAP5)","+",1011179,1011278,1011113,165,"W-close-W",1011113,1011278,"chrXV"
"chrXV","YOR359W (VTS1)","+",1012888,1012887,1012722,165,"F-close-F",1012722,1012887,"chrXV"
"chrXV","YOR360C (PDE2 SRA5)","-",1013139,1013101,1013373,272,"W-open-F",1013101,1013373,"chrXV"
"chrXV","YOR361C (PRT1 CDC63 DNA26)","-",1015275,1015013,1015361,348,"W-open-W",1015013,1015361,"chrXV"
"chrXV","YOR362C (PRE10)","-",1017744,1017508,1017784,276,"W-open-W",1017508,1017784,"chrXV"
"chrXV","YOR363C (PIP2 OAF2)","-",1019881,1019882,1020072,190,"W-close-W",1019882,1020072,"chrXV"
"chrXV","YOR364W","+",1024558,1024547,1024350,197,"W-close-F",1024350,1024547,"chrXV"
"chrXV","YOR366W","+",1025672,1025781,1025590,191,"W-close-W",1025590,1025781,"chrXV"
"chrXV","YOR367W (SCP1)","+",1026700,1026859,1026606,253,"F-open-W",1026606,1026859,"chrXV"
"chrXV","YOR368W (RAD17)","+",1028171,1028206,1028020,186,"W-close-F",1028020,1028206,"chrXV"
"chrXV","YOR369C (RPS12)","-",1028087,1028020,1028206,186,"F-close-W",1028020,1028206,"chrXV"
"chrXV","YOR370C (MRS6 MSI4)","-",1029021,NA,NA,NA,"+1_missing",1028686,1029077,"chrXV"
"chrXV","YOR371C (GPB1 KRH2)","-",1031405,1031282,1031594,312,"W-open-W",1031282,1031594,"chrXV"
"chrXV","YOR372C (NDD1)","-",1034474,1034267,1034495,228,"F-open-W",1034267,1034495,"chrXV"
"chrXV","YOR373W (NUD1)","+",1039492,1039764,1039357,407,"W-open-W",1039357,1039764,"chrXV"
"chrXV","YOR374W (ALD4 ALD7 ALDH2)","+",1041521,1041643,1041415,228,"F-open-F",1041415,1041643,"chrXV"
"chrXV","YOR375C (GDH1 DHE4 GDH-A GDHA URE1)","-",1041569,1041415,1041643,228,"F-open-F",1041415,1041643,"chrXV"
"chrXV","YOR376W-A","+",1045798,1045889,1045742,147,"W-close-F",1045742,1045889,"chrXV"
"chrXV","YOR377W (ATF1)","+",1048047,1048142,1047927,215,"F-close-W",1047927,1048142,"chrXV"
"chrXV","YOR378W","+",1051127,1051140,1050867,273,"W-open-W",1050867,1051140,"chrXV"
"chrXV","YOR380W (RDR1)","+",1052986,1053087,1052898,189,"F-close-F",1052898,1053087,"chrXV"
"chrXV","YOR381W (FRE3)","+",1057774,1057841,1057632,209,"F-close-W",1057632,1057841,"chrXV"
"chrXV","YOR381W-A","+",1059390,1059430,1059259,171,"W-close-W",1059259,1059430,"chrXV"
"chrXV","YOR382W (FIT2)","+",1060091,1060118,1059936,182,"W-close-F",1059936,1060118,"chrXV"
"chrXV","YOR383C (FIT3)","-",1060241,1060118,1060337,219,"W-open-F",1060118,1060337,"chrXV"
"chrXV","YOR384W (FRE5)","+",1064681,1064841,1064649,192,"W-close-W",1064649,1064841,"chrXV"
"chrXV","YOR385W","+",1066198,1066278,1066107,171,"F-close-W",1066107,1066278,"chrXV"
"chrXV","YOR386W (PHR1)","+",1068945,1069028,1068795,233,"F-open-F",1068795,1069028,"chrXV"
"chrXV","YOR389W","+",1076466,1076484,NA,NA,"-1_missing",1076145,1076484,"chrXV"
"chrXV","YOR390W","+",1078206,NA,NA,NA,"+1_missing",1077887,1079158,"chrXV"
"chrXVI","YPL001W (HAT1)","+",555769,555831,555635,196,"F-close-W",555635,555831,"chrXVI"
"chrXVI","YPL002C (SNF8 VPL14 VPS22)","-",553275,553265,553350,85,"W-overlap-F",553265,553350,"chrXVI"
"chrXVI","YPL003W (ULA1 ENR2)","+",553429,553517,553350,167,"W-close-W",553350,553517,"chrXVI"
"chrXVI","YPL004C (LSP1)","-",550440,550386,550530,144,"F-close-F",550386,550530,"chrXVI"
"chrXVI","YPL005W (AEP3)","+",550412,550530,550386,144,"F-close-F",550386,550530,"chrXVI"
"chrXVI","YPL006W (NCR1)","+",548217,548232,548072,160,"W-close-W",548072,548232,"chrXVI"
"chrXVI","YPL007C (TFC8)","-",541974,541987,542186,199,"F-close-F",541987,542186,"chrXVI"
"chrXVI","YPL008W (CHL1 CTF1 LPA9 MCM12)","+",542041,542186,541987,199,"F-close-F",541987,542186,"chrXVI"
"chrXVI","YPL009C (TAE2)","-",535619,535507,535693,186,"F-close-W",535507,535693,"chrXVI"
"chrXVI","YPL010W (RET3)","+",535733,535871,535693,178,"F-close-F",535693,535871,"chrXVI"
"chrXVI","YPL011C (TAF3 TAF47)","-",533521,533490,533578,88,"F-overlap-F",533490,533578,"chrXVI"
"chrXVI","YPL012W (RRP12)","+",533531,533578,533490,88,"F-overlap-F",533490,533578,"chrXVI"
"chrXVI","YPL013C (MRPS16)","-",528837,528831,529002,171,"W-close-F",528831,529002,"chrXVI"
"chrXVI","YPL014W","+",528948,529002,528831,171,"F-close-W",528831,529002,"chrXVI"
"chrXVI","YPL015C (HST2)","-",525487,525454,525533,79,"F-overlap-W",525454,525533,"chrXVI"
"chrXVI","YPL016W (SWI1 ADR6 GAM3 LPA1)","+",525070,525137,524888,249,"F-open-W",524888,525137,"chrXVI"
"chrXVI","YPL017C (IRC15)","-",518075,518015,518192,177,"W-close-W",518015,518192,"chrXVI"
"chrXVI","YPL018W (CTF19 MCM18)","+",519915,519988,519797,191,"F-close-W",519797,519988,"chrXVI"
"chrXVI","YPL019C (VTC3 PHM2)","-",514429,514248,514519,271,"W-open-W",514248,514519,"chrXVI"
"chrXVI","YPL020C (ULP1 NIB1)","-",512228,512178,512418,240,"W-open-F",512178,512418,"chrXVI"
"chrXVI","YPL022W (RAD1 LPB9)","+",510210,510309,509963,346,"W-open-W",509963,510309,"chrXVI"
"chrXVI","YPL023C (MET12)","-",504204,504016,504242,226,"W-open-F",504016,504242,"chrXVI"
"chrXVI","YPL024W (RMI1 NCE4)","+",504354,504415,504242,173,"W-close-W",504242,504415,"chrXVI"
"chrXVI","YPL025C","-",502260,502212,502296,84,"F-overlap-F",502212,502296,"chrXVI"
"chrXVI","YPL026C (SKS1 SHA3)","-",500428,500440,500548,108,"W-overlap-F",500440,500548,"chrXVI"
"chrXVI","YPL027W (SMA1)","+",500523,500548,500440,108,"F-overlap-W",500440,500548,"chrXVI"
"chrXVI","YPL028W (ERG10 LPB3 TSM0115)","+",499388,499579,499284,295,"F-open-W",499284,499579,"chrXVI"
"chrXVI","YPL029W (SUV3 LPB2)","+",497782,497997,497720,277,"W-open-W",497720,497997,"chrXVI"
"chrXVI","YPL030W (TRM44)","+",495353,495517,495274,243,"W-open-W",495274,495517,"chrXVI"
"chrXVI","YPL031C (PHO85 LDB15 phoU)","-",491936,491702,492047,345,"W-open-W",491702,492047,"chrXVI"
"chrXVI","YPL032C (SVL3)","-",488528,488436,488655,219,"F-open-F",488436,488655,"chrXVI"
"chrXVI","YPL033C (SRL4)","-",487208,487096,487251,155,"F-close-F",487096,487251,"chrXVI"
"chrXVI","YPL034W","+",487348,487410,487325,85,"F-overlap-F",487325,487410,"chrXVI"
"chrXVI","YPL035C","-",486275,486174,486427,253,"W-open-F",486174,486427,"chrXVI"
"chrXVI","YPL036W (PMA2)","+",486230,486427,486174,253,"F-open-W",486174,486427,"chrXVI"
"chrXVI","YPL037C (EGD1)","-",481366,481218,481440,222,"W-open-F",481218,481440,"chrXVI"
"chrXVI","YPL038W (MET31)","+",481180,481218,481057,161,"W-close-F",481057,481218,"chrXVI"
"chrXVI","YPL039W","+",480300,480314,480152,162,"W-close-F",480152,480314,"chrXVI"
"chrXVI","YPL040C (ISM1)","-",475925,475716,475954,238,"W-open-W",475716,475954,"chrXVI"
"chrXVI","YPL041C","-",474974,474922,475213,291,"W-open-W",474922,475213,"chrXVI"
"chrXVI","YPL042C (SSN3 CDK8 GIG2 NUT7 RYE5 SRB10 UME5)","-",472932,472859,473014,155,"F-close-F",472859,473014,"chrXVI"
"chrXVI","YPL043W (NOP4 NOP77)","+",472092,472157,472035,122,"F-close-F",472035,472157,"chrXVI"
"chrXVI","YPL045W (VPS16 SVL6 VAM9 VPT16)","+",469895,469937,469657,280,"W-open-W",469657,469937,"chrXVI"
"chrXVI","YPL046C (ELC1)","-",466425,466431,466620,189,"F-close-W",466431,466620,"chrXVI"
"chrXVI","YPL047W (SGF11)","+",466638,466620,466431,189,"W-close-F",466431,466620,"chrXVI"
"chrXVI","YPL048W (CAM1 TEF3)","+",465773,465908,465602,306,"W-open-W",465602,465908,"chrXVI"
"chrXVI","YPL049C (DIG1 RST1)","-",462306,462106,462391,285,"W-open-W",462106,462391,"chrXVI"
"chrXVI","YPL050C (MNN9)","-",460620,460505,460824,319,"W-open-W",460505,460824,"chrXVI"
"chrXVI","YPL051W (ARL3)","+",460726,460824,460505,319,"W-open-W",460505,460824,"chrXVI"
"chrXVI","YPL052W (OAZ1 YPL052W-A)","+",459768,459769,459598,171,"W-close-W",459598,459769,"chrXVI"
"chrXVI","YPL053C (KTR6 MNN6)","-",457014,456867,457037,170,"F-close-W",456867,457037,"chrXVI"
"chrXVI","YPL054W (LEE1)","+",457022,457037,456867,170,"W-close-F",456867,457037,"chrXVI"
"chrXVI","YPL055C (LGE1)","-",453920,453809,454002,193,"W-close-F",453809,454002,"chrXVI"
"chrXVI","YPL056C (LCL1)","-",453208,453165,453257,92,"F-overlap-F",453165,453257,"chrXVI"
"chrXVI","YPL057C (SUR1 BCL21 CSG1 LPE15)","-",451463,451409,451566,157,"F-close-W",451409,451566,"chrXVI"
"chrXVI","YPL058C (PDR12)","-",445607,445556,445752,196,"F-close-W",445556,445752,"chrXVI"
"chrXVI","YPL059W (GRX5)","+",445183,445188,445020,168,"W-close-W",445020,445188,"chrXVI"
"chrXVI","YPL060W (MFM1 LPE10)","+",435824,436111,435718,393,"W-open-W",435718,436111,"chrXVI"
"chrXVI","YPL061W (ALD6 ALD1)","+",434212,434293,434104,189,"F-close-F",434104,434293,"chrXVI"
"chrXVI","YPL062W","+",432512,432565,432363,202,"W-close-W",432363,432565,"chrXVI"
"chrXVI","YPL063W (TIM50)","+",431467,431496,431329,167,"W-close-W",431329,431496,"chrXVI"
"chrXVI","YPL064C (CWC27)","-",428639,428633,428779,146,"W-close-F",428633,428779,"chrXVI"
"chrXVI","YPL065W (VPS28 VPL13 VPT28)","+",428719,428779,428633,146,"F-close-W",428633,428779,"chrXVI"
"chrXVI","YPL066W","+",427778,427944,427676,268,"W-open-W",427676,427944,"chrXVI"
"chrXVI","YPL067C","-",425163,425095,NA,NA,"-1_missing",425095,425681,"chrXVI"
"chrXVI","YPL068C","-",424150,424120,424282,162,"W-close-W",424120,424282,"chrXVI"
"chrXVI","YPL069C (BTS1)","-",422740,422713,422896,183,"W-close-F",422713,422896,"chrXVI"
"chrXVI","YPL070W (MUK1)","+",422969,423004,422896,108,"W-overlap-F",422896,423004,"chrXVI"
"chrXVI","YPL071C","-",419960,419854,420044,190,"W-close-F",419854,420044,"chrXVI"
"chrXVI","YPL072W (UBP16)","+",420057,420044,419854,190,"F-close-W",419854,420044,"chrXVI"
"chrXVI","YPL074W (YTA6)","+",418165,418384,418096,288,"W-open-W",418096,418384,"chrXVI"
"chrXVI","YPL075W (GCR1 LPF10)","+",415580,415784,415496,288,"F-open-W",415496,415784,"chrXVI"
"chrXVI","YPL076W (GPI2 GCR4)","+",411719,411893,411625,268,"W-open-W",411625,411893,"chrXVI"
"chrXVI","YPL077C","-",409016,408936,409071,135,"W-close-F",408936,409071,"chrXVI"
"chrXVI","YPL078C (ATP4 LPF7)","-",407758,407726,407927,201,"F-close-F",407726,407927,"chrXVI"
"chrXVI","YPL079W (RPL21B)","+",407649,407637,407556,81,"F-overlap-F",407556,407637,"chrXVI"
"chrXVI","YPL081W (RPS9A)","+",406216,406269,406043,226,"W-open-W",406043,406269,"chrXVI"
"chrXVI","YPL082C (MOT1 BTAF1 BUR3 LPF4)","-",398358,398332,398528,196,"W-close-W",398332,398528,"chrXVI"
"chrXVI","YPL083C (SEN54)","-",396556,396525,396729,204,"F-close-W",396525,396729,"chrXVI"
"chrXVI","YPL084W (BRO1 ASI6 LPF2 NPI3 VPS31)","+",396722,396729,396525,204,"W-close-F",396525,396729,"chrXVI"
"chrXVI","YPL085W (SEC16 LPF1)","+",393764,393758,393571,187,"W-close-W",393571,393758,"chrXVI"
"chrXVI","YPL086C (ELP3 HPA1 KTI8 TOT3)","-",384654,384610,384692,82,"F-overlap-F",384610,384692,"chrXVI"
"chrXVI","YPL087W (YDC1)","+",384545,384610,384487,123,"W-close-F",384487,384610,"chrXVI"
"chrXVI","YPL088W","+",383077,383158,383027,131,"F-close-F",383027,383158,"chrXVI"
"chrXVI","YPL089C (RLM1)","-",378992,378973,379209,236,"F-open-W",378973,379209,"chrXVI"
"chrXVI","YPL090C (RPS6A)","-",377147,377101,377314,213,"W-close-W",377101,377314,"chrXVI"
"chrXVI","YPL091W (GLR1 LPG17)","+",377063,377101,376937,164,"W-close-W",376937,377101,"chrXVI"
"chrXVI","YPL092W (SSU1 LPG16)","+",375258,375278,375201,77,"W-overlap-F",375201,375278,"chrXVI"
"chrXVI","YPL093W (NOG1)","+",373158,373211,373126,85,"F-overlap-F",373126,373211,"chrXVI"
"chrXVI","YPL094C (SEC62 LPG14)","-",369768,369784,369962,178,"W-close-W",369784,369962,"chrXVI"
"chrXVI","YPL095C (EEB1)","-",368018,367960,368142,182,"W-close-W",367960,368142,"chrXVI"
"chrXVI","YPL096C-A (ERI1 RIN1)","-",366395,366402,366579,177,"W-close-W",366402,366579,"chrXVI"
"chrXVI","YPL096W (PNG1)","+",368088,368142,367960,182,"W-close-W",367960,368142,"chrXVI"
"chrXVI","YPL097W (MSY1)","+",366538,366579,366402,177,"W-close-W",366402,366579,"chrXVI"
"chrXVI","YPL098C (MGR2)","-",364216,364061,364247,186,"W-close-W",364061,364247,"chrXVI"
"chrXVI","YPL099C (AIM43 FMP14)","-",363331,363197,363377,180,"W-close-W",363197,363377,"chrXVI"
"chrXVI","YPL100W (ATG21 HSV1 MAI1)","+",363415,363545,363377,168,"W-close-W",363377,363545,"chrXVI"
"chrXVI","YPL101W (ELP4 HAP1 KTI9 TOT7)","+",361731,361870,361584,286,"F-open-W",361584,361870,"chrXVI"
"chrXVI","YPL103C (FMP30)","-",357718,357664,357739,75,"F-overlap-W",357664,357739,"chrXVI"
"chrXVI","YPL104W (MSD1 LPG5)","+",357812,357934,357739,195,"F-close-F",357739,357934,"chrXVI"
"chrXVI","YPL105C (SYH1)","-",352746,352654,352858,204,"W-close-W",352654,352858,"chrXVI"
"chrXVI","YPL106C (SSE1 LPG3 MSI3)","-",350044,349960,350252,292,"F-open-W",349960,350252,"chrXVI"
"chrXVI","YPL107W","+",350069,350252,349960,292,"W-open-F",349960,350252,"chrXVI"
"chrXVI","YPL109C","-",345185,345114,345311,197,"W-close-W",345114,345311,"chrXVI"
"chrXVI","YPL110C (GDE1)","-",340968,340891,341126,235,"F-open-F",340891,341126,"chrXVI"
"chrXVI","YPL111W (CAR1 LPH15 cargA)","+",341046,341126,340891,235,"F-open-F",340891,341126,"chrXVI"
"chrXVI","YPL112C (PEX25)","-",337370,337332,337522,190,"W-close-W",337332,337522,"chrXVI"
"chrXVI","YPL113C","-",335865,335719,335981,262,"W-open-W",335719,335981,"chrXVI"
"chrXVI","YPL114W","+",337452,337522,337332,190,"W-close-W",337332,337522,"chrXVI"
"chrXVI","YPL115C (BEM3)","-",331857,331684,331897,213,"W-close-F",331684,331897,"chrXVI"
"chrXVI","YPL116W (HOS3)","+",331832,331897,331684,213,"F-close-W",331684,331897,"chrXVI"
"chrXVI","YPL117C (IDI1 BOT2 LPH10)","-",327787,327564,327815,251,"F-open-W",327564,327815,"chrXVI"
"chrXVI","YPL118W (MRP51)","+",327761,327815,327564,251,"W-open-F",327564,327815,"chrXVI"
"chrXVI","YPL119C-A","-",323747,323751,323880,129,"F-close-F",323751,323880,"chrXVI"
"chrXVI","YPL120W (VPS30 APG6 ATG6 VPT30)","+",323844,323880,323751,129,"F-close-F",323751,323880,"chrXVI"
"chrXVI","YPL122C (TFB2)","-",319150,318954,319203,249,"W-open-W",318954,319203,"chrXVI"
"chrXVI","YPL123C (RNY1)","-",317500,317419,317646,227,"F-open-W",317419,317646,"chrXVI"
"chrXVI","YPL124W (SPC29 LPH3 NIP29)","+",317584,317646,317419,227,"W-open-F",317419,317646,"chrXVI"
"chrXVI","YPL125W (KAP120)","+",316554,316761,316507,254,"W-open-W",316507,316761,"chrXVI"
"chrXVI","YPL126W (NAN1 UTP17)","+",313197,313259,313027,232,"F-open-W",313027,313259,"chrXVI"
"chrXVI","YPL127C (HHO1)","-",308652,308629,308800,171,"W-close-W",308629,308800,"chrXVI"
"chrXVI","YPL128C (TBF1 LPI16)","-",306241,306147,306328,181,"F-close-W",306147,306328,"chrXVI"
"chrXVI","YPL129W (TAF14 ANC1 SWP29 TAF30 TFG3)","+",306243,306328,306147,181,"W-close-F",306147,306328,"chrXVI"
"chrXVI","YPL130W (SPO19)","+",305089,305288,304989,299,"W-open-W",304989,305288,"chrXVI"
"chrXVI","YPL131W (RPL5 LPI14 RPL1)","+",304109,304105,304016,89,"F-overlap-F",304016,304105,"chrXVI"
"chrXVI","YPL132W (COX11 LPI13 PSO7)","+",302696,302706,302535,171,"W-close-W",302535,302706,"chrXVI"
"chrXVI","YPL133C (RDS2)","-",299758,299578,299808,230,"W-open-F",299578,299808,"chrXVI"
"chrXVI","YPL134C (ODC1)","-",298458,298275,298618,343,"W-open-W",298275,298618,"chrXVI"
"chrXVI","YPL135C-A","-",296684,296590,296751,161,"W-close-W",296590,296751,"chrXVI"
"chrXVI","YPL135W (ISU1 NUA1)","+",298415,298618,298275,343,"W-open-W",298275,298618,"chrXVI"
"chrXVI","YPL137C (GIP3)","-",292651,292668,292872,204,"W-close-W",292668,292872,"chrXVI"
"chrXVI","YPL138C (SPP1 CPS40 SAF41)","-",291221,291061,291311,250,"W-open-W",291061,291311,"chrXVI"
"chrXVI","YPL139C (UME1 WTM3)","-",289578,289447,289669,222,"W-open-W",289447,289669,"chrXVI"
"chrXVI","YPL140C (MKK2 LPI6 SSP33)","-",287324,287045,287382,337,"W-open-F",287045,287382,"chrXVI"
"chrXVI","YPL141C (FRK1)","-",283101,282908,283157,249,"F-open-W",282908,283157,"chrXVI"
"chrXVI","YPL142C","-",282681,282571,282751,180,"W-close-F",282571,282751,"chrXVI"
"chrXVI","YPL143W (RPL33A RPL37A)","+",283099,283157,282908,249,"W-open-F",282908,283157,"chrXVI"
"chrXVI","YPL144W (POC4 DMP1 PBA4)","+",281000,281032,280812,220,"F-open-W",280812,281032,"chrXVI"
"chrXVI","YPL145C (KES1 BSR3 LPI3 OSH4)","-",277889,277824,278009,185,"W-close-W",277824,278009,"chrXVI"
"chrXVI","YPL146C (NOP53 RRP16)","-",276019,275967,276056,89,"W-overlap-F",275967,276056,"chrXVI"
"chrXVI","YPL147W (PXA1 LPI1 PAL1 PAT2 SSH2)","+",275945,275967,275887,80,"F-overlap-F",275887,275967,"chrXVI"
"chrXVI","YPL148C (PPT2)","-",272112,272112,272223,111,"W-overlap-F",272112,272223,"chrXVI"
"chrXVI","YPL149W (ATG5 APG5)","+",272227,272223,272112,111,"F-overlap-W",272112,272223,"chrXVI"
"chrXVI","YPL150W","+",271041,271303,270956,347,"F-open-W",270956,271303,"chrXVI"
"chrXVI","YPL151C (PRP46 NTC50)","-",266099,266095,266192,97,"F-overlap-F",266095,266192,"chrXVI"
"chrXVI","YPL152W (RRD2 YPA2)","+",266229,266385,266192,193,"F-close-F",266192,266385,"chrXVI"
"chrXVI","YPL153C (RAD53 LSD1 MEC2 SPK1)","-",261547,261439,261683,244,"F-open-W",261439,261683,"chrXVI"
"chrXVI","YPL154C (PEP4 PHO9 PRA1 yscA)","-",259588,259555,259809,254,"F-open-F",259555,259809,"chrXVI"
"chrXVI","YPL155C (KIP2)","-",256797,256738,256931,193,"W-close-W",256738,256931,"chrXVI"
"chrXVI","YPL156C (PRM4)","-",255781,255732,255805,73,"F-overlap-F",255732,255805,"chrXVI"
"chrXVI","YPL157W (TGS1)","+",256162,256269,256109,160,"F-close-F",256109,256269,"chrXVI"
"chrXVI","YPL158C (AIM44)","-",251979,251895,252056,161,"W-close-F",251895,252056,"chrXVI"
"chrXVI","YPL159C (PET20)","-",250599,250527,250738,211,"F-close-F",250527,250738,"chrXVI"
"chrXVI","YPL160W (CDC60)","+",250433,250527,250373,154,"F-close-F",250373,250527,"chrXVI"
"chrXVI","YPL161C (BEM4 ROM7)","-",244161,244053,244335,282,"W-open-W",244053,244335,"chrXVI"
"chrXVI","YPL162C","-",242938,242818,243082,264,"W-open-W",242818,243082,"chrXVI"
"chrXVI","YPL163C (SVS1)","-",241715,241498,241761,263,"W-open-W",241498,241761,"chrXVI"
"chrXVI","YPL164C (MLH3)","-",239090,238992,239217,225,"F-open-W",238992,239217,"chrXVI"
"chrXVI","YPL165C (SET6)","-",237640,237529,237700,171,"W-close-F",237529,237700,"chrXVI"
"chrXVI","YPL166W (ATG29)","+",239106,239217,238992,225,"W-open-F",238992,239217,"chrXVI"
"chrXVI","YPL167C (REV3 PSO1)","-",232495,232456,232630,174,"F-close-F",232456,232630,"chrXVI"
"chrXVI","YPL168W","+",232573,232630,232456,174,"F-close-F",232456,232630,"chrXVI"
"chrXVI","YPL169C (MEX67)","-",228838,228764,228957,193,"F-close-W",228764,228957,"chrXVI"
"chrXVI","YPL170W (DAP1)","+",228937,228957,228764,193,"W-close-F",228764,228957,"chrXVI"
"chrXVI","YPL171C (OYE3 ZRG6)","-",226032,225815,226075,260,"F-open-W",225815,226075,"chrXVI"
"chrXVI","YPL172C (COX10)","-",224214,224153,224242,89,"F-overlap-W",224153,224242,"chrXVI"
"chrXVI","YPL173W (MRPL40)","+",224191,224242,224153,89,"W-overlap-F",224153,224242,"chrXVI"
"chrXVI","YPL174C (NIP100 PAC13)","-",220094,220060,220313,253,"F-open-F",220060,220313,"chrXVI"
"chrXVI","YPL175W (SPT14 CWH6 GPI3)","+",220215,220313,220060,253,"F-open-F",220060,220313,"chrXVI"
"chrXVI","YPL176C (TRE1)","-",215845,215847,215967,120,"W-close-F",215847,215967,"chrXVI"
"chrXVI","YPL177C (CUP9)","-",212925,212798,213004,206,"F-close-F",212798,213004,"chrXVI"
"chrXVI","YPL178W (CBC2 CBP20 MUD13 SAE1)","+",212901,213004,212798,206,"F-close-F",212798,213004,"chrXVI"
"chrXVI","YPL179W (PPQ1 SAL6)","+",210056,NA,NA,NA,"+1_missing",210035,210415,"chrXVI"
"chrXVI","YPL180W (TCO89)","+",207849,208020,207659,361,"W-open-W",207659,208020,"chrXVI"
"chrXVI","YPL181W (CTI6 RXT1)","+",205049,205219,204938,281,"W-open-W",204938,205219,"chrXVI"
"chrXVI","YPL183C (RTT10)","-",199407,199391,199578,187,"W-close-W",199391,199578,"chrXVI"
"chrXVI","YPL183W-A (RTC6 GON5 TAE4)","+",199518,199578,199391,187,"W-close-W",199391,199578,"chrXVI"
"chrXVI","YPL184C (MRN1 PTR69)","-",195834,195843,196029,186,"W-close-W",195843,196029,"chrXVI"
"chrXVI","YPL185W","+",195991,196029,195843,186,"W-close-W",195843,196029,"chrXVI"
"chrXVI","YPL186C (UIP4)","-",194276,194167,194368,201,"F-close-W",194167,194368,"chrXVI"
"chrXVI","YPL187W (MF(ALPHA)1)","+",194364,194368,194167,201,"W-close-F",194167,194368,"chrXVI"
"chrXVI","YPL188W (POS5)","+",192909,193062,192884,178,"W-close-W",192884,193062,"chrXVI"
"chrXVI","YPL189C-A (COA2)","-",188056,187792,188111,319,"F-open-W",187792,188111,"chrXVI"
"chrXVI","YPL189W (GUP2)","+",191105,191166,190974,192,"W-close-W",190974,191166,"chrXVI"
"chrXVI","YPL190C (NAB3 HMD1)","-",184909,184916,185077,161,"F-close-W",184916,185077,"chrXVI"
"chrXVI","YPL191C","-",183177,183057,183233,176,"W-close-W",183057,183233,"chrXVI"
"chrXVI","YPL192C (PRM3)","-",182571,182549,182725,176,"W-close-W",182549,182725,"chrXVI"
"chrXVI","YPL193W (RSA1)","+",183124,183233,183057,176,"W-close-W",183057,183233,"chrXVI"
"chrXVI","YPL194W (DDC1)","+",181338,181392,181112,280,"W-open-W",181112,181392,"chrXVI"
"chrXVI","YPL195W (APL5 YKS4)","+",179127,179274,179017,257,"W-open-W",179017,179274,"chrXVI"
"chrXVI","YPL196W (OXR1)","+",175924,175983,175827,156,"W-close-W",175827,175983,"chrXVI"
"chrXVI","YPL198W (RPL7B)","+",174795,174849,174764,85,"F-overlap-F",174764,174849,"chrXVI"
"chrXVI","YPL199C","-",171968,171914,172086,172,"W-close-W",171914,172086,"chrXVI"
"chrXVI","YPL200W (CSM4)","+",172092,172086,171914,172,"W-close-W",171914,172086,"chrXVI"
"chrXVI","YPL201C (YIG1)","-",169433,169364,169719,355,"W-open-W",169364,169719,"chrXVI"
"chrXVI","YPL202C (AFT2)","-",167705,167640,167765,125,"F-close-F",167640,167765,"chrXVI"
"chrXVI","YPL203W (TPK2 PKA2 PKA3 YKR1)","+",167648,167640,167479,161,"F-close-F",167479,167640,"chrXVI"
"chrXVI","YPL204W (HRR25 KTI14)","+",165894,166123,165827,296,"F-open-W",165827,166123,"chrXVI"
"chrXVI","YPL206C (PGC1)","-",162520,162371,162657,286,"W-open-F",162371,162657,"chrXVI"
"chrXVI","YPL207W (TYW1)","+",162433,162657,162371,286,"F-open-W",162371,162657,"chrXVI"
"chrXVI","YPL208W (RKM1)","+",159665,159872,159539,333,"W-open-W",159539,159872,"chrXVI"
"chrXVI","YPL209C (IPL1 PAC15)","-",156387,156183,156493,310,"W-open-W",156183,156493,"chrXVI"
"chrXVI","YPL210C (SRP72)","-",154205,154210,154360,150,"F-close-F",154210,154360,"chrXVI"
"chrXVI","YPL211W (NIP7)","+",154225,154210,154138,72,"W-overlap-F",154138,154210,"chrXVI"
"chrXVI","YPL212C (PUS1)","-",151344,151265,NA,NA,"-1_missing",151265,151650,"chrXVI"
"chrXVI","YPL213W (LEA1)","+",151460,151650,151265,385,"W-open-F",151265,151650,"chrXVI"
"chrXVI","YPL214C (THI6)","-",148494,148462,148562,100,"F-overlap-F",148462,148562,"chrXVI"
"chrXVI","YPL215W (CBP3)","+",148597,148636,148562,74,"F-overlap-F",148562,148636,"chrXVI"
"chrXVI","YPL216W","+",147299,147431,147138,293,"W-open-W",147138,147431,"chrXVI"
"chrXVI","YPL217C (BMS1)","-",139547,139502,139680,178,"W-close-F",139502,139680,"chrXVI"
"chrXVI","YPL218W (SAR1)","+",139483,139502,139320,182,"W-close-F",139320,139502,"chrXVI"
"chrXVI","YPL219W (PCL8)","+",138364,138402,138202,200,"W-close-W",138202,138402,"chrXVI"
"chrXVI","YPL220W (RPL1A SSM1)","+",136545,136709,136442,267,"W-open-W",136442,136709,"chrXVI"
"chrXVI","YPL221W (FLC1 BOP1 HUF1)","+",135596,135817,135473,344,"W-open-W",135473,135817,"chrXVI"
"chrXVI","YPL222W (FMP40)","+",132318,NA,NA,NA,"+1_missing",132178,132646,"chrXVI"
"chrXVI","YPL223C (GRE1)","-",128404,128260,128516,256,"W-open-W",128260,128516,"chrXVI"
"chrXVI","YPL224C (MMT2 MFT2)","-",126445,126338,126472,134,"F-close-W",126338,126472,"chrXVI"
"chrXVI","YPL225W","+",126580,126680,126541,139,"F-close-F",126541,126680,"chrXVI"
"chrXVI","YPL226W (NEW1)","+",125609,125743,125552,191,"W-close-W",125552,125743,"chrXVI"
"chrXVI","YPL227C (ALG5)","-",120089,120039,120272,233,"W-open-F",120039,120272,"chrXVI"
"chrXVI","YPL228W (CET1 CES5)","+",120213,120272,120039,233,"F-open-W",120039,120272,"chrXVI"
"chrXVI","YPL229W","+",117961,118005,117853,152,"W-close-W",117853,118005,"chrXVI"
"chrXVI","YPL230W (USV1 NSF1)","+",116593,116640,116465,175,"W-close-F",116465,116640,"chrXVI"
"chrXVI","YPL231W (FAS2)","+",114400,114641,114318,323,"W-open-F",114318,114641,"chrXVI"
"chrXVI","YPL232W (SSO1)","+",108226,108233,108069,164,"W-close-W",108069,108233,"chrXVI"
"chrXVI","YPL233W (NSL1)","+",106910,107150,106741,409,"W-open-W",106741,107150,"chrXVI"
"chrXVI","YPL234C (VMA11 CLS9 TFP3)","-",104801,104781,104998,217,"F-open-W",104781,104998,"chrXVI"
"chrXVI","YPL235W (RVB2 TIH2 TIP48 TIP49B)","+",104726,104781,104637,144,"F-close-W",104637,104781,"chrXVI"
"chrXVI","YPL236C","-",101358,101305,101457,152,"F-close-W",101305,101457,"chrXVI"
"chrXVI","YPL237W (SUI3)","+",101465,101457,101305,152,"W-close-F",101305,101457,"chrXVI"
"chrXVI","YPL238C","-",100205,100204,NA,NA,"-1_missing",100204,100505,"chrXVI"
"chrXVI","YPL239W (YAR1)","+",100286,100505,100204,301,"W-open-W",100204,100505,"chrXVI"
"chrXVI","YPL240C (HSP82 HSP90)","-",96385,96195,96464,269,"F-open-F",96195,96464,"chrXVI"
"chrXVI","YPL241C (CIN2)","-",95292,95151,95482,331,"W-open-W",95151,95482,"chrXVI"
"chrXVI","YPL242C (IQG1 CYK1)","-",90459,90436,90543,107,"F-overlap-W",90436,90543,"chrXVI"
"chrXVI","YPL243W (SRP68)","+",90384,90436,90334,102,"F-overlap-W",90334,90436,"chrXVI"
"chrXVI","YPL244C (HUT1)","-",86898,86877,87040,163,"W-close-W",86877,87040,"chrXVI"
"chrXVI","YPL245W","+",87007,87040,86877,163,"W-close-W",86877,87040,"chrXVI"
"chrXVI","YPL246C (RBD2)","-",84410,84278,84534,256,"W-open-W",84278,84534,"chrXVI"
"chrXVI","YPL247C","-",82516,82324,82604,280,"W-open-W",82324,82604,"chrXVI"
"chrXVI","YPL248C (GAL4 GAL81)","-",79528,79335,79620,285,"W-open-W",79335,79620,"chrXVI"
"chrXVI","YPL249C (GYP5)","-",76604,NA,NA,NA,"+1_missing",76295,76702,"chrXVI"
"chrXVI","YPL249C-A (RPL36B)","-",75546,75382,75669,287,"W-open-F",75382,75669,"chrXVI"
"chrXVI","YPL250C (ICY2)","-",74118,74132,74315,183,"W-close-F",74132,74315,"chrXVI"
"chrXVI","YPL251W","+",74018,74132,73872,260,"W-open-F",73872,74132,"chrXVI"
"chrXVI","YPL252C (YAH1)","-",73234,73004,73293,289,"F-open-W",73004,73293,"chrXVI"
"chrXVI","YPL253C (VIK1)","-",70968,70913,71100,187,"W-close-W",70913,71100,"chrXVI"
"chrXVI","YPL254W (HFI1 ADA1 GAN1 SRM12 SUP110)","+",71018,71100,70913,187,"W-close-W",70913,71100,"chrXVI"
"chrXVI","YPL255W (BBP1)","+",69115,69308,69016,292,"W-open-W",69016,69308,"chrXVI"
"chrXVI","YPL256C (CLN2)","-",64774,64725,64810,85,"F-overlap-F",64725,64810,"chrXVI"
"chrXVI","YPL257W","+",64778,64810,64725,85,"F-overlap-F",64725,64810,"chrXVI"
"chrXVI","YPL258C (THI21)","-",53406,53306,53490,184,"W-close-W",53306,53490,"chrXVI"
"chrXVI","YPL259C (APM1 YAP54)","-",51038,51031,51195,164,"F-close-F",51031,51195,"chrXVI"
"chrXVI","YPL260W","+",51137,51195,51031,164,"F-close-F",51031,51195,"chrXVI"
"chrXVI","YPL261C","-",48736,48620,48761,141,"W-close-W",48620,48761,"chrXVI"
"chrXVI","YPL262W (FUM1)","+",48855,48932,48761,171,"W-close-W",48761,48932,"chrXVI"
"chrXVI","YPL263C (KEL3)","-",44473,44329,44586,257,"W-open-W",44329,44586,"chrXVI"
"chrXVI","YPL264C","-",43020,42932,43255,323,"F-open-W",42932,43255,"chrXVI"
"chrXVI","YPL265W (DIP5)","+",43148,43255,42932,323,"W-open-F",42932,43255,"chrXVI"
"chrXVI","YPL266W (DIM1 CDH1)","+",40150,40225,40037,188,"W-close-W",40037,40225,"chrXVI"
"chrXVI","YPL267W (ACM1)","+",38850,39115,38817,298,"W-open-W",38817,39115,"chrXVI"
"chrXVI","YPL268W (PLC1)","+",37909,37925,37741,184,"W-close-W",37741,37925,"chrXVI"
"chrXVI","YPL269W (KAR9)","+",35077,35248,34971,277,"F-open-W",34971,35248,"chrXVI"
"chrXVI","YPL270W (MDL2)","+",32902,33030,32768,262,"W-open-W",32768,33030,"chrXVI"
"chrXVI","YPL271W (ATP15 ATPEPSILON)","+",30410,30495,30250,245,"W-open-W",30250,30495,"chrXVI"
"chrXVI","YPL272C","-",26542,26485,26676,191,"W-close-W",26485,26676,"chrXVI"
"chrXVI","YPL273W (SAM4)","+",26167,26334,26058,276,"F-open-W",26058,26334,"chrXVI"
"chrXVI","YPL274W (SAM3)","+",24756,24830,24665,165,"W-close-F",24665,24830,"chrXVI"
"chrXVI","YPL278C","-",14972,NA,NA,NA,"+1_missing",14655,14996,"chrXVI"
"chrXVI","YPL279C","-",12967,12822,13236,414,"W-open-F",12822,13236,"chrXVI"
"chrXVI","YPR001W (CIT3)","+",557968,557963,557800,163,"W-close-W",557800,557963,"chrXVI"
"chrXVI","YPR002W (PDH1)","+",560132,560239,560088,151,"F-close-F",560088,560239,"chrXVI"
"chrXVI","YPR003C","-",561297,561280,561495,215,"W-close-W",561280,561495,"chrXVI"
"chrXVI","YPR004C (AIM45)","-",563958,563771,564061,290,"F-open-W",563771,564061,"chrXVI"
"chrXVI","YPR005C (HAL1)","-",565558,565490,565680,190,"W-close-W",565490,565680,"chrXVI"
"chrXVI","YPR006C (ICL2)","-",567152,567169,567369,200,"W-close-F",567169,567369,"chrXVI"
"chrXVI","YPR008W (HAA1)","+",575220,575457,575128,329,"F-open-W",575128,575457,"chrXVI"
"chrXVI","YPR009W (SUT2)","+",577440,577676,577326,350,"F-open-W",577326,577676,"chrXVI"
"chrXVI","YPR010C (RPA135 RPA2 RRN2 SRP3)","-",577439,577326,577676,350,"W-open-F",577326,577676,"chrXVI"
"chrXVI","YPR010C-A","-",582224,582069,582248,179,"F-close-F",582069,582248,"chrXVI"
"chrXVI","YPR011C","-",582863,582811,583067,256,"W-open-F",582811,583067,"chrXVI"
"chrXVI","YPR013C","-",584376,584309,584490,181,"W-close-W",584309,584490,"chrXVI"
"chrXVI","YPR014C","-",586397,586356,586538,182,"W-close-F",586356,586538,"chrXVI"
"chrXVI","YPR015C","-",590142,590009,590201,192,"F-close-W",590009,590201,"chrXVI"
"chrXVI","YPR016C (TIF6 CDC95)","-",592157,592142,592319,177,"W-close-F",592142,592319,"chrXVI"
"chrXVI","YPR017C (DSS4)","-",593299,593123,593439,316,"W-open-W",593123,593439,"chrXVI"
"chrXVI","YPR018W (RLF2 CAC1)","+",596431,596437,596263,174,"W-close-W",596263,596437,"chrXVI"
"chrXVI","YPR019W (MCM4 CDC54 HCD21)","+",599670,599857,599598,259,"W-open-W",599598,599857,"chrXVI"
"chrXVI","YPR020W (ATP20)","+",600327,600363,600195,168,"W-close-W",600195,600363,"chrXVI"
"chrXVI","YPR021C (AGC1)","-",600584,600523,600699,176,"W-close-F",600523,600699,"chrXVI"
"chrXVI","YPR022C","-",603747,603543,603790,247,"W-open-W",603543,603790,"chrXVI"
"chrXVI","YPR023C (EAF3)","-",608710,608697,608862,165,"W-close-W",608697,608862,"chrXVI"
"chrXVI","YPR024W (YME1 OSD1 YTA11)","+",613235,613355,613181,174,"F-close-W",613181,613355,"chrXVI"
"chrXVI","YPR025C (CCL1)","-",613248,613181,613355,174,"W-close-F",613181,613355,"chrXVI"
"chrXVI","YPR026W (ATH1)","+",619114,619130,619036,94,"F-overlap-F",619036,619130,"chrXVI"
"chrXVI","YPR027C","-",620277,620199,620372,173,"F-close-F",620199,620372,"chrXVI"
"chrXVI","YPR028W (YOP1 YIP2)","+",624351,624377,624291,86,"F-overlap-F",624291,624377,"chrXVI"
"chrXVI","YPR029C (APL4)","-",624244,624188,624291,103,"F-overlap-W",624188,624291,"chrXVI"
"chrXVI","YPR030W (CSR2 ART8 MRG19)","+",631322,631508,631259,249,"F-open-W",631259,631508,"chrXVI"
"chrXVI","YPR031W (NTO1)","+",633881,634141,633846,295,"W-open-W",633846,634141,"chrXVI"
"chrXVI","YPR032W (SRO7 SNI1 SOP1)","+",637327,637444,637149,295,"F-open-W",637149,637444,"chrXVI"
"chrXVI","YPR033C (HTS1 TSM4572)","-",637262,637149,637444,295,"W-open-F",637149,637444,"chrXVI"
"chrXVI","YPR034W (ARP7 RSC11 SWP61)","+",641207,NA,NA,NA,"+1_missing",641081,641657,"chrXVI"
"chrXVI","YPR035W (GLN1)","+",643484,643517,643249,268,"W-open-F",643249,643517,"chrXVI"
"chrXVI","YPR036W (VMA13 CLS11)","+",645362,645617,645199,418,"W-open-F",645199,645617,"chrXVI"
"chrXVI","YPR036W-A","+",646419,646553,646251,302,"F-open-F",646251,646553,"chrXVI"
"chrXVI","YPR037C (ERV2)","-",646320,646251,646553,302,"F-open-F",646251,646553,"chrXVI"
"chrXVI","YPR040W (TIP41)","+",648447,648633,648335,298,"W-open-W",648335,648633,"chrXVI"
"chrXVI","YPR041W (TIF5 SUI5)","+",650075,650122,650036,86,"F-overlap-F",650036,650122,"chrXVI"
"chrXVI","YPR042C (PUF2)","-",649994,649894,650036,142,"F-close-F",649894,650036,"chrXVI"
"chrXVI","YPR043W (RPL43A)","+",654920,654983,654782,201,"F-close-W",654782,654983,"chrXVI"
"chrXVI","YPR044C (OPI11)","-",653896,653733,654170,437,"W-open-W",653733,654170,"chrXVI"
"chrXVI","YPR045C (THP3 MNI2)","-",655033,654983,655183,200,"F-close-W",654983,655183,"chrXVI"
"chrXVI","YPR046W (MCM16)","+",657416,657524,657306,218,"W-open-W",657306,657524,"chrXVI"
"chrXVI","YPR047W (MSF1)","+",659042,659199,658944,255,"W-open-W",658944,659199,"chrXVI"
"chrXVI","YPR048W (TAH18)","+",661133,661216,661103,113,"F-overlap-W",661103,661216,"chrXVI"
"chrXVI","YPR049C (ATG11 CVT9)","-",661049,661030,661103,73,"F-overlap-F",661030,661103,"chrXVI"
"chrXVI","YPR050C","-",664917,664699,664983,284,"W-open-W",664699,664983,"chrXVI"
"chrXVI","YPR051W (MAK3 NAA30)","+",665603,665641,665446,195,"W-close-W",665446,665641,"chrXVI"
"chrXVI","YPR052C (NHP6A)","-",665494,665446,665641,195,"W-close-W",665446,665641,"chrXVI"
"chrXVI","YPR053C","-",665513,665446,665641,195,"W-close-W",665446,665641,"chrXVI"
"chrXVI","YPR054W (SMK1)","+",667495,667674,667377,297,"W-open-W",667377,667674,"chrXVI"
"chrXVI","YPR055W (SEC8)","+",670936,671140,670880,260,"W-open-W",670880,671140,"chrXVI"
"chrXVI","YPR056W (TFB4)","+",672279,672316,672240,76,"F-overlap-W",672240,672316,"chrXVI"
"chrXVI","YPR057W (BRR1)","+",673552,673711,673457,254,"W-open-W",673457,673711,"chrXVI"
"chrXVI","YPR058W (YMC1)","+",674778,674844,674652,192,"F-close-W",674652,674844,"chrXVI"
"chrXVI","YPR059C","-",673671,673457,673711,254,"W-open-W",673457,673711,"chrXVI"
"chrXVI","YPR060C (ARO7 HGS1 OSM2 TYR7)","-",674727,674652,674844,192,"W-close-F",674652,674844,"chrXVI"
"chrXVI","YPR061C (JID1)","-",675860,675660,675909,249,"W-open-W",675660,675909,"chrXVI"
"chrXVI","YPR062W (FCY1 yCD)","+",677739,677827,677672,155,"W-close-W",677672,677827,"chrXVI"
"chrXVI","YPR063C","-",677619,677518,677672,154,"W-close-W",677518,677672,"chrXVI"
"chrXVI","YPR065W (ROX1 REO1)","+",680987,681037,680904,133,"F-close-F",680904,681037,"chrXVI"
"chrXVI","YPR067W (ISA2)","+",682927,683075,682899,176,"W-close-W",682899,683075,"chrXVI"
"chrXVI","YPR068C (HOS1)","-",682828,682728,682899,171,"W-close-W",682728,682899,"chrXVI"
"chrXVI","YPR069C (SPE3)","-",684489,684322,684554,232,"W-open-W",684322,684554,"chrXVI"
"chrXVI","YPR070W (MED1)","+",687944,688007,687916,91,"W-overlap-F",687916,688007,"chrXVI"
"chrXVI","YPR071W","+",689261,689295,689050,245,"F-open-F",689050,689295,"chrXVI"
"chrXVI","YPR072W (NOT5)","+",691876,691946,691755,191,"F-close-W",691755,691946,"chrXVI"
"chrXVI","YPR073C (LTP1)","-",691694,691637,691755,118,"F-overlap-W",691637,691755,"chrXVI"
"chrXVI","YPR074C (TKL1)","-",692669,692436,692867,431,"W-open-W",692436,692867,"chrXVI"
"chrXVI","YPR075C (OPY2)","-",695621,695379,695650,271,"F-open-W",695379,695650,"chrXVI"
"chrXVI","YPR076W","+",696869,697134,696845,289,"W-open-W",696845,697134,"chrXVI"
"chrXVI","YPR077C","-",697040,696845,697134,289,"W-open-W",696845,697134,"chrXVI"
"chrXVI","YPR078C","-",697040,696845,697134,289,"W-open-W",696845,697134,"chrXVI"
"chrXVI","YPR079W (MRL1)","+",700097,NA,NA,NA,"+1_missing",699975,700580,"chrXVI"
"chrXVI","YPR080W (TEF1 EF-1%20alpha)","+",702091,702181,701957,224,"F-open-F",701957,702181,"chrXVI"
"chrXVI","YPR081C (GRS2)","-",701990,701957,702181,224,"F-open-F",701957,702181,"chrXVI"
"chrXVI","YPR082C (DIB1 SNU16)","-",704127,704127,704311,184,"W-close-W",704127,704311,"chrXVI"
"chrXVI","YPR083W (MDM36)","+",706714,706917,706681,236,"W-open-W",706681,706917,"chrXVI"
"chrXVI","YPR084W","+",708485,708574,708354,220,"F-open-F",708354,708574,"chrXVI"
"chrXVI","YPR085C (ASA1)","-",708384,708354,708574,220,"F-open-F",708354,708574,"chrXVI"
"chrXVI","YPR086W (SUA7 SOH4)","+",711308,711367,711253,114,"F-overlap-F",711253,711367,"chrXVI"
"chrXVI","YPR088C (SRP54 SRH1)","-",711320,711253,711367,114,"F-overlap-F",711253,711367,"chrXVI"
"chrXVI","YPR089W (YPR090W)","+",716081,716219,716041,178,"F-close-F",716041,716219,"chrXVI"
"chrXVI","YPR091C","-",715952,715875,716041,166,"F-close-W",715875,716041,"chrXVI"
"chrXVI","YPR093C (ASR1)","-",719469,719306,719632,326,"W-open-W",719306,719632,"chrXVI"
"chrXVI","YPR094W (RDS3)","+",721030,721172,720996,176,"F-close-F",720996,721172,"chrXVI"
"chrXVI","YPR095C (SYT1)","-",720939,720830,720996,166,"F-close-W",720830,720996,"chrXVI"
"chrXVI","YPR097W","+",728782,728839,728610,229,"W-open-W",728610,728839,"chrXVI"
"chrXVI","YPR098C","-",728773,728610,728839,229,"W-open-W",728610,728839,"chrXVI"
"chrXVI","YPR100W (MRPL51)","+",730312,730520,730248,272,"F-open-W",730248,730520,"chrXVI"
"chrXVI","YPR101W (SNT309 NTC25)","+",731233,731286,731106,180,"F-close-W",731106,731286,"chrXVI"
"chrXVI","YPR102C (RPL11A)","-",731133,731106,731286,180,"W-close-F",731106,731286,"chrXVI"
"chrXVI","YPR103W (PRE2 DOA3 PRG1 SRR2)","+",733327,733342,733254,88,"W-overlap-F",733254,733342,"chrXVI"
"chrXVI","YPR104C (FHL1 SPP42)","-",733277,733254,733342,88,"F-overlap-W",733254,733342,"chrXVI"
"chrXVI","YPR105C (COG4 COD1 SEC38 SGF1)","-",736911,736666,736975,309,"W-open-W",736666,736975,"chrXVI"
"chrXVI","YPR106W (ISR1)","+",741439,741470,741267,203,"F-close-W",741267,741470,"chrXVI"
"chrXVI","YPR107C (YTH1)","-",741300,741267,741470,203,"W-close-F",741267,741470,"chrXVI"
"chrXVI","YPR108W (RPN7)","+",743922,743952,743791,161,"W-close-W",743791,743952,"chrXVI"
"chrXVI","YPR109W","+",745666,745664,745487,177,"W-close-W",745487,745664,"chrXVI"
"chrXVI","YPR110C (RPC40 RPC5)","-",745620,745487,745664,177,"W-close-W",745487,745664,"chrXVI"
"chrXVI","YPR111W (DBF20)","+",749078,749111,749021,90,"F-overlap-F",749021,749111,"chrXVI"
"chrXVI","YPR112C (MRD1)","-",749152,749111,749316,205,"F-close-F",749111,749316,"chrXVI"
"chrXVI","YPR113W (PIS1)","+",753029,753277,752999,278,"W-open-W",752999,753277,"chrXVI"
"chrXVI","YPR114W","+",754363,754428,754258,170,"W-close-W",754258,754428,"chrXVI"
"chrXVI","YPR115W (RGC1 GCA1)","+",758400,758441,758235,206,"W-close-F",758235,758441,"chrXVI"
"chrXVI","YPR116W (RRG8)","+",759813,759945,759756,189,"W-close-W",759756,759945,"chrXVI"
"chrXVI","YPR117W","+",767566,767765,767503,262,"F-open-W",767503,767765,"chrXVI"
"chrXVI","YPR118W (MRI1)","+",769058,769076,768913,163,"W-close-F",768913,769076,"chrXVI"
"chrXVI","YPR119W (CLB2)","+",773419,773458,773373,85,"F-overlap-F",773373,773458,"chrXVI"
"chrXVI","YPR120C (CLB5)","-",773835,NA,NA,NA,"+1_missing",773530,773897,"chrXVI"
"chrXVI","YPR121W (THI22)","+",780364,780622,780255,367,"F-open-F",780255,780622,"chrXVI"
"chrXVI","YPR122W (AXL1 FUS5 STE22)","+",785815,785933,785788,145,"W-close-F",785788,785933,"chrXVI"
"chrXVI","YPR124W (CTR1)","+",787653,787907,787632,275,"W-open-W",787632,787907,"chrXVI"
"chrXVI","YPR125W (YLH47 MRS7)","+",789508,789553,789365,188,"W-close-W",789365,789553,"chrXVI"
"chrXVI","YPR126C","-",788821,788716,788881,165,"W-close-W",788716,788881,"chrXVI"
"chrXVI","YPR127W","+",791200,791238,791041,197,"F-close-F",791041,791238,"chrXVI"
"chrXVI","YPR128C (ANT1)","-",791119,791041,791238,197,"F-close-F",791041,791238,"chrXVI"
"chrXVI","YPR129W (SCD6 LSM13)","+",793815,793857,793667,190,"W-close-F",793667,793857,"chrXVI"
"chrXVI","YPR131C (NAT3 NAA20)","-",793751,793667,793857,190,"F-close-W",793667,793857,"chrXVI"
"chrXVI","YPR132W (RPS23B)","+",795870,795942,795758,184,"F-close-F",795758,795942,"chrXVI"
"chrXVI","YPR133C (SPN1 IWS1)","-",795899,795758,795942,184,"F-close-F",795758,795942,"chrXVI"
"chrXVI","YPR133W-A (TOM5 MOM8A)","+",797877,797891,797727,164,"W-close-W",797727,797891,"chrXVI"
"chrXVI","YPR134W (MSS18)","+",798990,799005,798831,174,"F-close-W",798831,799005,"chrXVI"
"chrXVI","YPR135W (CTF4 CHL15 POB1)","+",802066,802325,801972,353,"W-open-W",801972,802325,"chrXVI"
"chrXVI","YPR137W (RRP9)","+",804240,804303,804095,208,"F-close-W",804095,804303,"chrXVI"
"chrXVI","YPR138C (MEP3)","-",810843,810696,810921,225,"F-open-F",810696,810921,"chrXVI"
"chrXVI","YPR139C (VPS66)","-",813061,NA,NA,NA,"+1_missing",812689,813118,"chrXVI"
"chrXVI","YPR140W (TAZ1)","+",815626,815672,815478,194,"W-close-W",815478,815672,"chrXVI"
"chrXVI","YPR141C (KAR3 OSR11)","-",815564,815478,815672,194,"W-close-W",815478,815672,"chrXVI"
"chrXVI","YPR143W (RRP15)","+",819233,819396,819210,186,"W-close-W",819210,819396,"chrXVI"
"chrXVI","YPR144C (NOC4 UTP19)","-",819686,819396,819748,352,"W-open-W",819396,819748,"chrXVI"
"chrXVI","YPR145C-A","-",824369,824261,824448,187,"F-close-W",824261,824448,"chrXVI"
"chrXVI","YPR145W (ASN1)","+",824478,824665,824448,217,"F-open-W",824448,824665,"chrXVI"
"chrXVI","YPR147C","-",825449,825437,825608,171,"W-close-W",825437,825608,"chrXVI"
"chrXVI","YPR148C","-",826717,826588,826826,238,"F-open-W",826588,826826,"chrXVI"
"chrXVI","YPR149W (NCE102 NCE2)","+",830798,830886,830574,312,"F-open-F",830574,830886,"chrXVI"
"chrXVI","YPR150W","+",831775,831787,831603,184,"W-close-W",831603,831787,"chrXVI"
"chrXVI","YPR151C (SUE1)","-",830970,830886,831063,177,"W-close-F",830886,831063,"chrXVI"
"chrXVI","YPR152C (URN1)","-",831785,831787,831963,176,"W-close-W",831787,831963,"chrXVI"
"chrXVI","YPR153W","+",834395,834572,834280,292,"W-open-W",834280,834572,"chrXVI"
"chrXVI","YPR154W (PIN3 LSB2)","+",835417,835412,835262,150,"F-close-F",835262,835412,"chrXVI"
"chrXVI","YPR155C (NCA2)","-",835468,835412,835516,104,"F-overlap-F",835412,835516,"chrXVI"
"chrXVI","YPR156C (TPO3)","-",837735,837450,837845,395,"W-open-W",837450,837845,"chrXVI"
"chrXVI","YPR157W","+",842785,842889,842714,175,"F-close-W",842714,842889,"chrXVI"
"chrXVI","YPR158W (CUR1)","+",844178,844359,844096,263,"W-open-W",844096,844359,"chrXVI"
"chrXVI","YPR159W (KRE6 CWH48)","+",860029,860171,859994,177,"F-close-W",859994,860171,"chrXVI"
"chrXVI","YPR160W (GPH1)","+",864164,864174,864077,97,"F-overlap-F",864077,864174,"chrXVI"
"chrXVI","YPR161C (SGV1 BUR1)","-",864345,864288,864379,91,"F-overlap-F",864288,864379,"chrXVI"
"chrXVI","YPR162C (ORC4)","-",866662,866436,866742,306,"W-open-W",866436,866742,"chrXVI"
"chrXVI","YPR163C (TIF3 RBL3 STM1)","-",868484,868267,868511,244,"F-open-W",868267,868511,"chrXVI"
"chrXVI","YPR164W (MMS1 RTT108 SLM6)","+",875199,875193,NA,NA,"-1_missing",874842,875193,"chrXVI"
"chrXVI","YPR165W (RHO1)","+",876197,876253,876021,232,"F-open-F",876021,876253,"chrXVI"
"chrXVI","YPR166C (MRP2)","-",876181,876021,876253,232,"F-open-F",876021,876253,"chrXVI"
"chrXVI","YPR167C (MET16)","-",876776,876606,876892,286,"W-open-W",876606,876892,"chrXVI"
"chrXVI","YPR169W (JIP5)","+",880244,880508,880120,388,"W-open-W",880120,880508,"chrXVI"
"chrXVI","YPR169W-A","+",883605,883833,883574,259,"W-open-W",883574,883833,"chrXVI"
"chrXVI","YPR170C","-",882602,882553,882622,69,"F-overlap-F",882553,882622,"chrXVI"
"chrXVI","YPR170W-A","+",883605,883833,883574,259,"W-open-W",883574,883833,"chrXVI"
"chrXVI","YPR170W-B","+",883803,883833,883574,259,"W-open-W",883574,883833,"chrXVI"
"chrXVI","YPR171W (BSP1)","+",885651,885808,885550,258,"W-open-W",885550,885808,"chrXVI"
"chrXVI","YPR172W","+",886517,886551,886342,209,"W-close-W",886342,886551,"chrXVI"
"chrXVI","YPR173C (VPS4 CSC1 DID6 END13 GRD13 VPL4 VPT10)","-",886397,886342,886551,209,"W-close-W",886342,886551,"chrXVI"
"chrXVI","YPR174C","-",887921,887816,888088,272,"W-open-W",887816,888088,"chrXVI"
"chrXVI","YPR175W (DPB2)","+",891098,891235,891057,178,"F-close-W",891057,891235,"chrXVI"
"chrXVI","YPR176C (BET2)","-",890952,890875,891057,182,"F-close-W",890875,891057,"chrXVI"
"chrXVI","YPR178W (PRP4 RNA4)","+",893820,893909,893660,249,"F-open-F",893660,893909,"chrXVI"
"chrXVI","YPR179C (HDA3 PLO1)","-",893732,893660,893909,249,"F-open-F",893660,893909,"chrXVI"
"chrXVI","YPR180W (AOS1 RHC31)","+",897038,897106,897009,97,"F-overlap-F",897009,897106,"chrXVI"
"chrXVI","YPR181C (SEC23)","-",897143,897106,897237,131,"F-close-F",897106,897237,"chrXVI"
"chrXVI","YPR182W (SMX3)","+",900531,900754,900485,269,"W-open-W",900485,900754,"chrXVI"
"chrXVI","YPR183W (DPM1 SED3)","+",901648,NA,NA,NA,"+1_missing",901520,901952,"chrXVI"
"chrXVI","YPR184W (GDB1)","+",906799,906951,906711,240,"F-open-W",906711,906951,"chrXVI"
"chrXVI","YPR185W (ATG13 APG13)","+",909508,909621,909410,211,"F-close-F",909410,909621,"chrXVI"
"chrXVI","YPR186C (PZF1 TFC2)","-",909608,909621,909802,181,"W-close-F",909621,909802,"chrXVI"
"chrXVI","YPR187W (RPO26 RPB6)","+",911924,911943,911759,184,"W-close-W",911759,911943,"chrXVI"
"chrXVI","YPR188C (MLC2)","-",911898,911759,911943,184,"W-close-W",911759,911943,"chrXVI"
"chrXVI","YPR189W (SKI3 SKI5)","+",917089,917133,917038,95,"F-overlap-F",917038,917133,"chrXVI"
"chrXVI","YPR190C (RPC82 RPC3)","-",916983,916911,917038,127,"F-close-F",916911,917038,"chrXVI"
"chrXVI","YPR191W (QCR2 COR2 UCR2)","+",920715,920849,920675,174,"F-close-F",920675,920849,"chrXVI"
"chrXVI","YPR192W (AQY1)","+",922917,923066,922860,206,"F-close-F",922860,923066,"chrXVI"
"chrXVI","YPR193C (HPA2)","-",921059,921028,921099,71,"W-overlap-F",921028,921099,"chrXVI"
"chrXVI","YPR194C (OPT2)","-",924143,923957,924214,257,"W-open-W",923957,924214,"chrXVI"
"chrXVI","YPR195C","-",927456,927400,927556,156,"W-close-F",927400,927556,"chrXVI"
"chrXVI","YPR196W","+",933201,933277,933104,173,"F-close-F",933104,933277,"chrXVI"
"chrXVI","YPR198W (SGE1 NOR1)","+",935825,935859,935711,148,"F-close-F",935711,935859,"chrXVI"
"chrXVI","YPR199C (ARR1 ACR1 YAP8)","-",937969,937936,938062,126,"F-close-F",937936,938062,"chrXVI"
"chrXVI","YPR201W (ARR3 ACR3)","+",942212,942300,942151,149,"W-close-W",942151,942300,"chrXVI"
